investor	('investor',)
presentation	('presentation',)
investor~presentation	('investor~presentation',)
investor~presentation~presentation	('presentation~investor~presentation',)
investor~investor~presentation~presentation	('investor~presentation~investor~presentation',)
q2	('q2',)
presentation~q2	('presentation~q2',)
investor~presentation~q2	('investor~presentation~q2',)
investor~presentation~q2~q2	('q2~investor~presentation~q2',)
fy24	('fy24',)
fy24~q2	('q2~fy24', 'fy24~q2')
fy24~presentation~q2	('presentation~q2~fy24',)
fy24~investor~presentation~q2	('investor~presentation~q2~fy24',)
august	('august',)
28	('28',)
28~august	('august~28',)
28~28~august	('28~august~28',)
28~28~august~august	('august~28~august~28',)
2023	('2023',)
2023~28	('28~2023',)
2023~28~august	('august~28~2023',)
2023~2023~28~august	('2023~august~28~2023',)
except	('except',)
historical	('historical',)
except~historical	('except~historical',)
except~historical~historical	('historical~except~historical',)
except~except~historical~historical	('except~historical~except~historical',)
information	('information',)
historical~information	('historical~information',)
except~historical~information	('except~historical~information',)
except~historical~information~information	('information~except~historical~information',)
contained	('contained',)
contained~information	('information~contained',)
contained~historical~information	('historical~information~contained',)
contained~except~historical~information	('except~historical~information~contained',)
herein	('herein',)
contained~herein	('contained~herein',)
contained~herein~information	('information~contained~herein',)
contained~herein~historical~information	('historical~information~contained~herein',)
certain	('certain',)
certain~herein	('herein~certain',)
certain~contained~herein	('contained~herein~certain',)
certain~contained~herein~information	('information~contained~herein~certain',)
matters	('matters',)
certain~matters	('certain~matters',)
certain~herein~matters	('herein~certain~matters',)
certain~contained~herein~matters	('contained~herein~certain~matters',)
matters~presentation	('matters~presentation',)
certain~matters~presentation	('certain~matters~presentation',)
certain~herein~matters~presentation	('herein~certain~matters~presentation',)
including	('including',)
including~presentation	('presentation~including',)
including~matters~presentation	('matters~presentation~including',)
certain~including~matters~presentation	('certain~matters~presentation~including',)
not	('not',)
including~not	('including~not', 'not~including')
including~not~presentation	('presentation~including~not',)
including~matters~not~presentation	('matters~presentation~including~not',)
limited	('limited',)
limited~not	('not~limited',)
including~limited~not	('including~not~limited',)
including~limited~not~presentation	('presentation~including~not~limited',)
statements	('statements',)
limited~statements	('limited~statements',)
limited~not~statements	('not~limited~statements',)
including~limited~not~statements	('including~not~limited~statements',)
financial	('financial',)
financial~statements	('statements~financial', 'financial~statements')
financial~limited~statements	('limited~statements~financial',)
financial~limited~not~statements	('not~limited~statements~financial',)
position	('position',)
financial~position	('financial~position',)
financial~position~statements	('statements~financial~position',)
financial~limited~position~statements	('limited~statements~financial~position',)
markets	('markets',)
markets~position	('position~markets',)
financial~markets~position	('financial~position~markets',)
financial~markets~position~statements	('statements~financial~position~markets',)
market	('market',)
market~markets	('markets~market',)
market~markets~position	('position~markets~market', 'markets~market~position')
financial~market~markets~position	('financial~position~markets~market',)
opportunity	('opportunity',)
market~opportunity	('market~opportunity',)
market~markets~opportunity	('markets~market~opportunity',)
market~markets~opportunity~position	('position~markets~market~opportunity',)
demand	('demand',)
demand~opportunity	('opportunity~demand',)
demand~market~opportunity	('market~opportunity~demand',)
demand~market~markets~opportunity	('markets~market~opportunity~demand',)
growth	('growth',)
demand~growth	('demand~growth',)
demand~growth~opportunity	('opportunity~demand~growth',)
demand~growth~market~opportunity	('market~opportunity~demand~growth',)
drivers	('drivers',)
drivers~growth	('growth~drivers',)
demand~drivers~growth	('demand~growth~drivers',)
demand~drivers~growth~opportunity	('opportunity~demand~growth~drivers',)
csps	('csps',)
csps~drivers	('drivers~csps',)
csps~drivers~growth	('growth~drivers~csps',)
csps~demand~drivers~growth	('demand~growth~drivers~csps',)
undertaking	('undertaking',)
csps~undertaking	('csps~undertaking',)
csps~drivers~undertaking	('drivers~csps~undertaking',)
csps~drivers~growth~undertaking	('growth~drivers~csps~undertaking',)
generational	('generational',)
generational~undertaking	('undertaking~generational',)
csps~generational~undertaking	('csps~undertaking~generational',)
csps~drivers~generational~undertaking	('drivers~csps~undertaking~generational',)
transition	('transition',)
generational~transition	('generational~transition',)
generational~transition~undertaking	('undertaking~generational~transition',)
csps~generational~transition~undertaking	('csps~undertaking~generational~transition',)
update	('update',)
transition~update	('transition~update',)
generational~transition~update	('generational~transition~update',)
generational~transition~undertaking~update	('undertaking~generational~transition~update',)
infrastructure	('infrastructure',)
infrastructure~update	('update~infrastructure',)
infrastructure~transition~update	('transition~update~infrastructure',)
generational~infrastructure~transition~update	('generational~transition~update~infrastructure',)
new	('new',)
infrastructure~new	('infrastructure~new',)
infrastructure~new~update	('update~infrastructure~new',)
infrastructure~new~transition~update	('transition~update~infrastructure~new',)
era	('era',)
era~new	('new~era',)
era~infrastructure~new	('infrastructure~new~era',)
era~infrastructure~new~update	('update~infrastructure~new~era',)
accelerated	('accelerated',)
accelerated~era	('era~accelerated',)
accelerated~era~new	('new~era~accelerated',)
accelerated~era~infrastructure~new	('infrastructure~new~era~accelerated',)
computing	('computing',)
accelerated~computing	('accelerated~computing',)
accelerated~computing~era	('era~accelerated~computing',)
accelerated~computing~era~new	('new~era~accelerated~computing',)
ai	('ai',)
ai~computing	('computing~ai', 'ai~computing')
accelerated~ai~computing	('accelerated~computing~ai', 'ai~accelerated~computing', 'accelerated~ai~computing')
accelerated~ai~computing~era	('era~accelerated~computing~ai',)
enterprises	('enterprises',)
ai~enterprises	('ai~enterprises',)
ai~computing~enterprises	('computing~ai~enterprises',)
accelerated~ai~computing~enterprises	('accelerated~computing~ai~enterprises',)
racing	('racing',)
enterprises~racing	('enterprises~racing',)
ai~enterprises~racing	('ai~enterprises~racing',)
ai~computing~enterprises~racing	('computing~ai~enterprises~racing',)
adopt	('adopt',)
adopt~racing	('racing~adopt',)
adopt~enterprises~racing	('enterprises~racing~adopt',)
adopt~ai~enterprises~racing	('ai~enterprises~racing~adopt',)
generative	('generative',)
adopt~generative	('adopt~generative',)
adopt~generative~racing	('racing~adopt~generative',)
adopt~enterprises~generative~racing	('enterprises~racing~adopt~generative',)
ai~generative	('generative~ai',)
adopt~ai~generative	('adopt~generative~ai',)
adopt~ai~generative~racing	('racing~adopt~generative~ai',)
belief	('belief',)
ai~belief	('ai~belief',)
ai~belief~generative	('generative~ai~belief',)
adopt~ai~belief~generative	('adopt~generative~ai~belief',)
global	('global',)
belief~global	('belief~global',)
ai~belief~global	('ai~belief~global',)
ai~belief~generative~global	('generative~ai~belief~global',)
end	('end',)
end~global	('global~end',)
belief~end~global	('belief~global~end',)
ai~belief~end~global	('ai~belief~global~end',)
demand~end	('end~demand',)
demand~end~global	('global~end~demand',)
belief~demand~end~global	('belief~global~end~demand',)
gaming	('gaming',)
demand~gaming	('demand~gaming', 'gaming~demand')
demand~end~gaming	('end~demand~gaming',)
demand~end~gaming~global	('global~end~demand~gaming',)
has	('has',)
gaming~has	('gaming~has',)
demand~gaming~has	('demand~gaming~has',)
demand~end~gaming~has	('end~demand~gaming~has',)
returned	('returned',)
has~returned	('has~returned',)
gaming~has~returned	('gaming~has~returned',)
demand~gaming~has~returned	('demand~gaming~has~returned',)
growth~returned	('returned~growth',)
growth~has~returned	('has~returned~growth',)
gaming~growth~has~returned	('gaming~has~returned~growth',)
growing	('growing',)
growing~growth	('growth~growing',)
growing~growth~returned	('returned~growth~growing',)
growing~growth~has~returned	('has~returned~growth~growing',)
number	('number',)
growing~number	('growing~number',)
growing~growth~number	('growth~growing~number',)
growing~growth~number~returned	('returned~growth~growing~number',)
gpu	('gpu',)
gpu~number	('number~gpu',)
gpu~growing~number	('growing~number~gpu',)
gpu~growing~growth~number	('growth~growing~number~gpu',)
cloud	('cloud',)
cloud~gpu	('gpu~cloud',)
cloud~gpu~number	('number~gpu~cloud',)
cloud~gpu~growing~number	('growing~number~gpu~cloud', 'cloud~growing~number~gpu')
providers	('providers',)
cloud~providers	('cloud~providers',)
cloud~gpu~providers	('gpu~cloud~providers',)
cloud~gpu~number~providers	('number~gpu~cloud~providers',)
deploying	('deploying',)
deploying~providers	('providers~deploying',)
cloud~deploying~providers	('cloud~providers~deploying',)
cloud~deploying~gpu~providers	('gpu~cloud~providers~deploying',)
volume	('volume',)
deploying~volume	('deploying~volume',)
deploying~providers~volume	('providers~deploying~volume',)
cloud~deploying~providers~volume	('cloud~providers~deploying~volume',)
hgx	('hgx',)
hgx~volume	('volume~hgx',)
deploying~hgx~volume	('deploying~volume~hgx',)
deploying~hgx~providers~volume	('providers~deploying~volume~hgx',)
systems	('systems',)
hgx~systems	('hgx~systems',)
hgx~systems~volume	('volume~hgx~systems',)
deploying~hgx~systems~volume	('deploying~volume~hgx~systems',)
based	('based',)
based~systems	('systems~based',)
based~hgx~systems	('hgx~systems~based',)
based~hgx~systems~volume	('volume~hgx~systems~based',)
hopper	('hopper',)
based~hopper	('based~hopper',)
based~hopper~systems	('systems~based~hopper',)
based~hgx~hopper~systems	('hgx~systems~based~hopper',)
ampere	('ampere',)
ampere~hopper	('hopper~ampere',)
ampere~based~hopper	('based~hopper~ampere',)
ampere~based~hopper~systems	('systems~based~hopper~ampere',)
ampere~gpu	('ampere~gpu',)
ampere~gpu~hopper	('hopper~ampere~gpu',)
ampere~based~gpu~hopper	('based~hopper~ampere~gpu',)
architecture	('architecture',)
architecture~gpu	('gpu~architecture',)
ampere~architecture~gpu	('ampere~gpu~architecture',)
ampere~architecture~gpu~hopper	('hopper~ampere~gpu~architecture',)
expectation	('expectation',)
architecture~expectation	('architecture~expectation',)
architecture~expectation~gpu	('gpu~architecture~expectation',)
ampere~architecture~expectation~gpu	('ampere~gpu~architecture~expectation',)
data	('data',)
data~expectation	('expectation~data',)
architecture~data~expectation	('architecture~expectation~data',)
architecture~data~expectation~gpu	('gpu~architecture~expectation~data',)
center	('center',)
center~data	('data~center',)
center~data~expectation	('expectation~data~center',)
architecture~center~data~expectation	('architecture~expectation~data~center',)
supply	('supply',)
center~supply	('center~supply',)
center~data~supply	('data~center~supply',)
center~data~expectation~supply	('expectation~data~center~supply',)
increase	('increase',)
increase~supply	('supply~increase',)
center~increase~supply	('center~supply~increase',)
center~data~increase~supply	('data~center~supply~increase',)
each	('each',)
each~increase	('increase~each',)
each~increase~supply	('supply~increase~each',)
center~each~increase~supply	('center~supply~increase~each',)
quarter	('quarter',)
each~quarter	('each~quarter',)
each~increase~quarter	('increase~each~quarter',)
each~increase~quarter~supply	('supply~increase~each~quarter',)
next	('next',)
next~quarter	('quarter~next',)
each~next~quarter	('each~quarter~next',)
each~increase~next~quarter	('increase~each~quarter~next',)
year	('year',)
next~year	('next~year',)
next~quarter~year	('quarter~next~year',)
each~next~quarter~year	('each~quarter~next~year',)
large	('large',)
large~year	('year~large',)
large~next~year	('next~year~large',)
large~next~quarter~year	('quarter~next~year~large',)
upgrade	('upgrade',)
large~upgrade	('large~upgrade',)
large~upgrade~year	('year~large~upgrade',)
large~next~upgrade~year	('next~year~large~upgrade',)
opportunity~upgrade	('upgrade~opportunity',)
large~opportunity~upgrade	('large~upgrade~opportunity',)
large~opportunity~upgrade~year	('year~large~upgrade~opportunity',)
ahead	('ahead',)
ahead~opportunity	('opportunity~ahead',)
ahead~opportunity~upgrade	('upgrade~opportunity~ahead',)
ahead~large~opportunity~upgrade	('large~upgrade~opportunity~ahead',)
likelihood	('likelihood',)
ahead~likelihood	('ahead~likelihood',)
ahead~likelihood~opportunity	('opportunity~ahead~likelihood',)
ahead~likelihood~opportunity~upgrade	('upgrade~opportunity~ahead~likelihood',)
seasonality	('seasonality',)
likelihood~seasonality	('likelihood~seasonality',)
ahead~likelihood~seasonality	('ahead~likelihood~seasonality',)
ahead~likelihood~opportunity~seasonality	('opportunity~ahead~likelihood~seasonality',)
overall	('overall',)
overall~seasonality	('seasonality~overall',)
likelihood~overall~seasonality	('likelihood~seasonality~overall',)
ahead~likelihood~overall~seasonality	('ahead~likelihood~seasonality~overall',)
gaming~overall	('overall~gaming',)
gaming~overall~seasonality	('seasonality~overall~gaming', 'overall~gaming~seasonality')
gaming~likelihood~overall~seasonality	('likelihood~seasonality~overall~gaming',)
gaming~market	('gaming~market', 'market~gaming')
gaming~market~overall	('overall~gaming~market',)
gaming~market~overall~seasonality	('seasonality~overall~gaming~market',)
shift	('shift',)
market~shift	('market~shift',)
gaming~market~shift	('gaming~market~shift',)
gaming~market~overall~shift	('overall~gaming~market~shift',)
rtx	('rtx',)
rtx~shift	('shift~rtx',)
market~rtx~shift	('market~shift~rtx',)
gaming~market~rtx~shift	('gaming~market~shift~rtx',)
dlss	('dlss',)
dlss~rtx	('rtx~dlss',)
dlss~rtx~shift	('shift~rtx~dlss',)
dlss~market~rtx~shift	('market~shift~rtx~dlss',)
ecosystem	('ecosystem',)
dlss~ecosystem	('dlss~ecosystem',)
dlss~ecosystem~rtx	('rtx~dlss~ecosystem',)
dlss~ecosystem~rtx~shift	('shift~rtx~dlss~ecosystem',)
continuing	('continuing',)
continuing~ecosystem	('ecosystem~continuing',)
continuing~dlss~ecosystem	('dlss~ecosystem~continuing',)
continuing~dlss~ecosystem~rtx	('rtx~dlss~ecosystem~continuing',)
expand	('expand',)
continuing~expand	('continuing~expand',)
continuing~ecosystem~expand	('ecosystem~continuing~expand',)
continuing~dlss~ecosystem~expand	('dlss~ecosystem~continuing~expand',)
timing	('timing',)
expand~timing	('expand~timing',)
continuing~expand~timing	('continuing~expand~timing',)
continuing~ecosystem~expand~timing	('ecosystem~continuing~expand~timing',)
desktop	('desktop',)
desktop~timing	('timing~desktop',)
desktop~expand~timing	('expand~timing~desktop',)
continuing~desktop~expand~timing	('continuing~expand~timing~desktop',)
workstation	('workstation',)
desktop~workstation	('desktop~workstation',)
desktop~timing~workstation	('timing~desktop~workstation',)
desktop~expand~timing~workstation	('expand~timing~desktop~workstation',)
refresh	('refresh',)
refresh~workstation	('workstation~refresh',)
desktop~refresh~workstation	('desktop~workstation~refresh',)
desktop~refresh~timing~workstation	('timing~desktop~workstation~refresh',)
expanding	('expanding',)
expanding~refresh	('refresh~expanding',)
expanding~refresh~workstation	('workstation~refresh~expanding',)
desktop~expanding~refresh~workstation	('desktop~workstation~refresh~expanding',)
expanding~opportunity	('expanding~opportunity',)
expanding~opportunity~refresh	('refresh~expanding~opportunity',)
expanding~opportunity~refresh~workstation	('workstation~refresh~expanding~opportunity',)
professional	('professional',)
opportunity~professional	('opportunity~professional',)
expanding~opportunity~professional	('expanding~opportunity~professional',)
expanding~opportunity~professional~refresh	('refresh~expanding~opportunity~professional',)
visualization	('visualization',)
professional~visualization	('professional~visualization',)
opportunity~professional~visualization	('opportunity~professional~visualization',)
expanding~opportunity~professional~visualization	('expanding~opportunity~professional~visualization',)
rtx~visualization	('visualization~rtx',)
professional~rtx~visualization	('professional~visualization~rtx',)
opportunity~professional~rtx~visualization	('opportunity~professional~visualization~rtx',)
technology	('technology',)
rtx~technology	('rtx~technology',)
rtx~technology~visualization	('visualization~rtx~technology',)
professional~rtx~technology~visualization	('professional~visualization~rtx~technology',)
impact	('impact',)
impact~technology	('technology~impact',)
impact~rtx~technology	('rtx~technology~impact',)
impact~rtx~technology~visualization	('visualization~rtx~technology~impact',)
partnership	('partnership',)
impact~partnership	('impact~partnership',)
impact~partnership~technology	('technology~impact~partnership',)
impact~partnership~rtx~technology	('rtx~technology~impact~partnership',)
mediatek	('mediatek',)
mediatek~partnership	('partnership~mediatek',)
impact~mediatek~partnership	('impact~partnership~mediatek',)
impact~mediatek~partnership~technology	('technology~impact~partnership~mediatek',)
financial~mediatek	('mediatek~financial',)
financial~mediatek~partnership	('partnership~mediatek~financial',)
financial~impact~mediatek~partnership	('impact~partnership~mediatek~financial',)
outlook	('outlook',)
financial~outlook	('financial~outlook',)
financial~mediatek~outlook	('mediatek~financial~outlook',)
financial~mediatek~outlook~partnership	('partnership~mediatek~financial~outlook',)
expectation~outlook	('outlook~expectation',)
expectation~financial~outlook	('financial~outlook~expectation',)
expectation~financial~mediatek~outlook	('mediatek~financial~outlook~expectation',)
sequential	('sequential',)
expectation~sequential	('expectation~sequential',)
expectation~outlook~sequential	('outlook~expectation~sequential',)
expectation~financial~outlook~sequential	('financial~outlook~expectation~sequential',)
growth~sequential	('sequential~growth',)
expectation~growth~sequential	('expectation~sequential~growth',)
expectation~growth~outlook~sequential	('outlook~expectation~sequential~growth',)
driven	('driven',)
driven~growth	('growth~driven',)
driven~growth~sequential	('sequential~growth~driven',)
driven~expectation~growth~sequential	('expectation~sequential~growth~driven',)
largely	('largely',)
driven~largely	('driven~largely',)
driven~growth~largely	('growth~driven~largely',)
driven~growth~largely~sequential	('sequential~growth~driven~largely',)
data~largely	('largely~data',)
data~driven~largely	('driven~largely~data',)
data~driven~growth~largely	('growth~driven~largely~data',)
center~data~largely	('largely~data~center',)
center~data~driven~largely	('driven~largely~data~center',)
center~gaming	('center~gaming',)
center~data~gaming	('data~center~gaming', 'gaming~data~center')
center~data~gaming~largely	('largely~data~center~gaming',)
gaming~professional	('gaming~professional',)
center~gaming~professional	('center~gaming~professional',)
center~data~gaming~professional	('data~center~gaming~professional', 'gaming~data~center~professional')
gaming~professional~visualization	('gaming~professional~visualization', 'professional~visualization~gaming')
center~gaming~professional~visualization	('center~gaming~professional~visualization', 'center~professional~visualization~gaming')
also	('also',)
also~visualization	('visualization~also',)
also~professional~visualization	('professional~visualization~also',)
also~gaming~professional~visualization	('gaming~professional~visualization~also',)
contributing	('contributing',)
also~contributing	('also~contributing',)
also~contributing~visualization	('visualization~also~contributing',)
also~contributing~professional~visualization	('professional~visualization~also~contributing',)
expected	('expected',)
contributing~expected	('contributing~expected',)
also~contributing~expected	('also~contributing~expected',)
also~contributing~expected~visualization	('visualization~also~contributing~expected',)
tax	('tax',)
expected~tax	('expected~tax',)
contributing~expected~tax	('contributing~expected~tax',)
also~contributing~expected~tax	('also~contributing~expected~tax',)
rates	('rates',)
rates~tax	('tax~rates',)
expected~rates~tax	('expected~tax~rates',)
contributing~expected~rates~tax	('contributing~expected~tax~rates',)
third	('third',)
rates~third	('rates~third',)
rates~tax~third	('tax~rates~third',)
expected~rates~tax~third	('expected~tax~rates~third',)
quarter~third	('third~quarter',)
quarter~rates~third	('rates~third~quarter',)
quarter~rates~tax~third	('tax~rates~third~quarter',)
fiscal	('fiscal',)
fiscal~quarter	('quarter~fiscal',)
fiscal~quarter~third	('third~quarter~fiscal',)
fiscal~quarter~rates~third	('rates~third~quarter~fiscal',)
2024	('2024',)
2024~fiscal	('fiscal~2024',)
2024~fiscal~quarter	('quarter~fiscal~2024',)
2024~fiscal~quarter~third	('third~quarter~fiscal~2024',)
benefits	('benefits',)
2024~benefits	('2024~benefits',)
2024~benefits~fiscal	('fiscal~2024~benefits',)
2024~benefits~fiscal~quarter	('quarter~fiscal~2024~benefits',)
benefits~impact	('benefits~impact', 'impact~benefits')
2024~benefits~impact	('2024~benefits~impact',)
2024~benefits~fiscal~impact	('fiscal~2024~benefits~impact',)
performance	('performance',)
impact~performance	('impact~performance',)
benefits~impact~performance	('benefits~impact~performance',)
2024~benefits~impact~performance	('2024~benefits~impact~performance',)
features	('features',)
features~performance	('performance~features', 'features~performance')
features~impact~performance	('impact~performance~features',)
benefits~features~impact~performance	('benefits~impact~performance~features',)
availability	('availability',)
availability~features	('features~availability',)
availability~features~performance	('performance~features~availability', 'features~performance~availability')
availability~features~impact~performance	('impact~performance~features~availability',)
products	('products',)
availability~products	('availability~products',)
availability~features~products	('features~availability~products',)
availability~features~performance~products	('performance~features~availability~products', 'features~performance~availability~products')
technologies	('technologies',)
products~technologies	('products~technologies',)
availability~products~technologies	('availability~products~technologies',)
availability~features~products~technologies	('features~availability~products~technologies',)
benefits~technologies	('technologies~benefits',)
benefits~products~technologies	('products~technologies~benefits',)
availability~benefits~products~technologies	('availability~products~technologies~benefits',)
benefits~impact~technologies	('technologies~benefits~impact',)
benefits~impact~products~technologies	('products~technologies~benefits~impact',)
features~impact	('impact~features',)
benefits~features~impact	('benefits~impact~features',)
benefits~features~impact~technologies	('technologies~benefits~impact~features',)
features~timing	('features~timing', 'timing~features')
features~impact~timing	('impact~features~timing',)
benefits~features~impact~timing	('benefits~impact~features~timing',)
collaborations	('collaborations',)
collaborations~timing	('timing~collaborations',)
collaborations~features~timing	('features~timing~collaborations',)
collaborations~features~impact~timing	('impact~features~timing~collaborations',)
partnerships	('partnerships',)
collaborations~partnerships	('collaborations~partnerships',)
collaborations~partnerships~timing	('timing~collaborations~partnerships',)
collaborations~features~partnerships~timing	('features~timing~collaborations~partnerships',)
nvidia	('nvidia',)
nvidia~partnerships	('partnerships~nvidia',)
collaborations~nvidia~partnerships	('collaborations~partnerships~nvidia',)
collaborations~nvidia~partnerships~timing	('timing~collaborations~partnerships~nvidia',)
accelerated~nvidia	('nvidia~accelerated',)
accelerated~nvidia~partnerships	('partnerships~nvidia~accelerated',)
accelerated~collaborations~nvidia~partnerships	('collaborations~partnerships~nvidia~accelerated',)
accelerated~computing~nvidia	('nvidia~accelerated~computing',)
accelerated~computing~nvidia~partnerships	('partnerships~nvidia~accelerated~computing',)
being	('being',)
being~computing	('computing~being',)
accelerated~being~computing	('accelerated~computing~being',)
accelerated~being~computing~nvidia	('nvidia~accelerated~computing~being',)
broadly	('broadly',)
being~broadly	('being~broadly',)
being~broadly~computing	('computing~being~broadly',)
accelerated~being~broadly~computing	('accelerated~computing~being~broadly',)
recognized	('recognized',)
broadly~recognized	('broadly~recognized',)
being~broadly~recognized	('being~broadly~recognized',)
being~broadly~computing~recognized	('computing~being~broadly~recognized',)
way	('way',)
recognized~way	('recognized~way',)
broadly~recognized~way	('broadly~recognized~way',)
being~broadly~recognized~way	('being~broadly~recognized~way',)
advance	('advance',)
advance~way	('way~advance',)
advance~recognized~way	('recognized~way~advance',)
advance~broadly~recognized~way	('broadly~recognized~way~advance',)
advance~computing	('advance~computing',)
advance~computing~way	('way~advance~computing',)
advance~computing~recognized~way	('recognized~way~advance~computing',)
moores	('moores',)
computing~moores	('computing~moores',)
advance~computing~moores	('advance~computing~moores',)
advance~computing~moores~way	('way~advance~computing~moores',)
law	('law',)
law~moores	('moores~law',)
computing~law~moores	('computing~moores~law',)
advance~computing~law~moores	('advance~computing~moores~law',)
ends	('ends',)
ends~law	('law~ends',)
ends~law~moores	('moores~law~ends',)
computing~ends~law~moores	('computing~moores~law~ends',)
accelerated~ends	('ends~accelerated',)
accelerated~ends~law	('law~ends~accelerated',)
accelerated~ends~law~moores	('moores~law~ends~accelerated',)
accelerated~computing~ends	('ends~accelerated~computing',)
accelerated~computing~ends~law	('law~ends~accelerated~computing',)
accelerated~being~computing~ends	('ends~accelerated~computing~being',)
needed	('needed',)
being~needed	('being~needed',)
being~computing~needed	('computing~being~needed',)
accelerated~being~computing~needed	('accelerated~computing~being~needed',)
tackle	('tackle',)
needed~tackle	('needed~tackle',)
being~needed~tackle	('being~needed~tackle',)
being~computing~needed~tackle	('computing~being~needed~tackle',)
most	('most',)
most~tackle	('tackle~most',)
most~needed~tackle	('needed~tackle~most',)
being~most~needed~tackle	('being~needed~tackle~most',)
impactful	('impactful',)
impactful~most	('most~impactful',)
impactful~most~tackle	('tackle~most~impactful',)
impactful~most~needed~tackle	('needed~tackle~most~impactful',)
opportunities	('opportunities',)
impactful~opportunities	('impactful~opportunities',)
impactful~most~opportunities	('most~impactful~opportunities',)
impactful~most~opportunities~tackle	('tackle~most~impactful~opportunities',)
time	('time',)
opportunities~time	('opportunities~time',)
impactful~opportunities~time	('impactful~opportunities~time',)
impactful~most~opportunities~time	('most~impactful~opportunities~time',)
nvidias	('nvidias',)
nvidias~time	('time~nvidias',)
nvidias~opportunities~time	('opportunities~time~nvidias',)
impactful~nvidias~opportunities~time	('impactful~opportunities~time~nvidias',)
expanding~nvidias	('nvidias~expanding',)
expanding~nvidias~time	('time~nvidias~expanding',)
expanding~nvidias~opportunities~time	('opportunities~time~nvidias~expanding',)
accelerated~expanding	('expanding~accelerated',)
accelerated~expanding~nvidias	('nvidias~expanding~accelerated',)
accelerated~expanding~nvidias~time	('time~nvidias~expanding~accelerated',)
accelerated~computing~expanding	('expanding~accelerated~computing',)
accelerated~computing~expanding~nvidias	('nvidias~expanding~accelerated~computing',)
computing~ecosystem	('computing~ecosystem',)
accelerated~computing~ecosystem	('accelerated~computing~ecosystem',)
accelerated~computing~ecosystem~expanding	('expanding~accelerated~computing~ecosystem',)
ecosystem~nvidias	('ecosystem~nvidias',)
computing~ecosystem~nvidias	('computing~ecosystem~nvidias',)
accelerated~computing~ecosystem~nvidias	('accelerated~computing~ecosystem~nvidias',)
value	('value',)
nvidias~value	('nvidias~value',)
ecosystem~nvidias~value	('ecosystem~nvidias~value',)
computing~ecosystem~nvidias~value	('computing~ecosystem~nvidias~value',)
every	('every',)
every~value	('value~every',)
every~nvidias~value	('nvidias~value~every',)
ecosystem~every~nvidias~value	('ecosystem~nvidias~value~every',)
stakeholder	('stakeholder',)
every~stakeholder	('every~stakeholder',)
every~stakeholder~value	('value~every~stakeholder',)
every~nvidias~stakeholder~value	('nvidias~value~every~stakeholder',)
ecosystem~stakeholder	('stakeholder~ecosystem',)
ecosystem~every~stakeholder	('every~stakeholder~ecosystem',)
ecosystem~every~stakeholder~value	('value~every~stakeholder~ecosystem',)
ai~ecosystem	('ecosystem~ai',)
ai~ecosystem~stakeholder	('stakeholder~ecosystem~ai',)
ai~ecosystem~every~stakeholder	('every~stakeholder~ecosystem~ai',)
greatest	('greatest',)
ai~greatest	('ai~greatest',)
ai~ecosystem~greatest	('ecosystem~ai~greatest',)
ai~ecosystem~greatest~stakeholder	('stakeholder~ecosystem~ai~greatest',)
greatest~technology	('greatest~technology',)
ai~greatest~technology	('ai~greatest~technology',)
ai~ecosystem~greatest~technology	('ecosystem~ai~greatest~technology',)
force	('force',)
force~technology	('technology~force',)
force~greatest~technology	('greatest~technology~force',)
ai~force~greatest~technology	('ai~greatest~technology~force',)
force~time	('force~time',)
force~technology~time	('technology~force~time',)
force~greatest~technology~time	('greatest~technology~force~time',)
generative~time	('time~generative',)
force~generative~time	('force~time~generative',)
force~generative~technology~time	('technology~force~time~generative',)
ai~generative~time	('time~generative~ai',)
ai~force~generative~time	('force~time~generative~ai',)
unlocking	('unlocking',)
ai~unlocking	('ai~unlocking',)
ai~generative~unlocking	('generative~ai~unlocking',)
ai~generative~time~unlocking	('time~generative~ai~unlocking',)
new~unlocking	('unlocking~new',)
ai~new~unlocking	('ai~unlocking~new',)
ai~generative~new~unlocking	('generative~ai~unlocking~new',)
new~opportunities	('new~opportunities', 'opportunities~new')
new~opportunities~unlocking	('unlocking~new~opportunities',)
ai~new~opportunities~unlocking	('ai~unlocking~new~opportunities', 'unlocking~new~opportunities~ai')
data~opportunities	('opportunities~data',)
data~new~opportunities	('new~opportunities~data',)
data~new~opportunities~unlocking	('unlocking~new~opportunities~data',)
centers	('centers',)
centers~data	('data~centers',)
centers~data~opportunities	('opportunities~data~centers',)
centers~data~new~opportunities	('new~opportunities~data~centers',)
industries	('industries',)
centers~industries	('centers~industries',)
centers~data~industries	('data~centers~industries',)
centers~data~industries~opportunities	('opportunities~data~centers~industries',)
becoming	('becoming',)
becoming~industries	('industries~becoming',)
becoming~centers~industries	('centers~industries~becoming',)
becoming~centers~data~industries	('data~centers~industries~becoming',)
ai~becoming	('becoming~ai', 'ai~becoming')
ai~becoming~industries	('industries~becoming~ai',)
ai~becoming~centers~industries	('centers~industries~becoming~ai',)
factories	('factories',)
ai~factories	('ai~factories',)
ai~becoming~factories	('becoming~ai~factories',)
ai~becoming~factories~industries	('industries~becoming~ai~factories',)
factories~next	('factories~next',)
ai~factories~next	('ai~factories~next',)
ai~becoming~factories~next	('becoming~ai~factories~next',)
wave	('wave',)
next~wave	('next~wave',)
factories~next~wave	('factories~next~wave',)
ai~factories~next~wave	('ai~factories~next~wave', 'factories~next~wave~ai')
ai~wave	('wave~ai',)
ai~next~wave	('next~wave~ai',)
ai~being	('ai~being',)
ai~being~wave	('wave~ai~being',)
ai~being~next~wave	('next~wave~ai~being',)
robotics	('robotics',)
being~robotics	('being~robotics',)
ai~being~robotics	('ai~being~robotics',)
ai~being~robotics~wave	('wave~ai~being~robotics',)
industrial	('industrial',)
industrial~robotics	('robotics~industrial',)
being~industrial~robotics	('being~robotics~industrial',)
ai~being~industrial~robotics	('ai~being~robotics~industrial',)
digitalization	('digitalization',)
digitalization~industrial	('industrial~digitalization',)
digitalization~industrial~robotics	('robotics~industrial~digitalization',)
being~digitalization~industrial~robotics	('being~robotics~industrial~digitalization',)
omniverse	('omniverse',)
digitalization~omniverse	('digitalization~omniverse',)
digitalization~industrial~omniverse	('industrial~digitalization~omniverse', 'omniverse~industrial~digitalization')
digitalization~industrial~omniverse~robotics	('robotics~industrial~digitalization~omniverse',)
being~omniverse	('omniverse~being',)
being~digitalization~omniverse	('digitalization~omniverse~being',)
being~digitalization~industrial~omniverse	('industrial~digitalization~omniverse~being',)
essential	('essential',)
being~essential	('being~essential',)
being~essential~omniverse	('omniverse~being~essential',)
being~digitalization~essential~omniverse	('digitalization~omniverse~being~essential',)
essential~robotics	('essential~robotics',)
being~essential~robotics	('being~essential~robotics',)
being~essential~omniverse~robotics	('omniverse~being~essential~robotics',)
nvidias~robotics	('robotics~nvidias',)
essential~nvidias~robotics	('essential~robotics~nvidias',)
being~essential~nvidias~robotics	('being~essential~robotics~nvidias',)
acceleration	('acceleration',)
acceleration~nvidias	('nvidias~acceleration',)
acceleration~nvidias~robotics	('robotics~nvidias~acceleration',)
acceleration~essential~nvidias~robotics	('essential~robotics~nvidias~acceleration',)
stacks	('stacks',)
acceleration~stacks	('acceleration~stacks',)
acceleration~nvidias~stacks	('nvidias~acceleration~stacks',)
acceleration~nvidias~robotics~stacks	('robotics~nvidias~acceleration~stacks',)
ecosystems	('ecosystems',)
ecosystems~stacks	('stacks~ecosystems',)
acceleration~ecosystems~stacks	('acceleration~stacks~ecosystems',)
acceleration~ecosystems~nvidias~stacks	('nvidias~acceleration~stacks~ecosystems',)
helping	('helping',)
ecosystems~helping	('ecosystems~helping',)
ecosystems~helping~stacks	('stacks~ecosystems~helping',)
acceleration~ecosystems~helping~stacks	('acceleration~stacks~ecosystems~helping',)
bring	('bring',)
bring~helping	('helping~bring',)
bring~ecosystems~helping	('ecosystems~helping~bring',)
bring~ecosystems~helping~stacks	('stacks~ecosystems~helping~bring',)
ai~bring	('bring~ai',)
ai~bring~helping	('helping~bring~ai',)
ai~bring~ecosystems~helping	('ecosystems~helping~bring~ai',)
worlds	('worlds',)
ai~worlds	('ai~worlds', 'worlds~ai')
ai~bring~worlds	('bring~ai~worlds',)
ai~bring~helping~worlds	('helping~bring~ai~worlds',)
largest	('largest',)
largest~worlds	('worlds~largest',)
ai~largest~worlds	('ai~worlds~largest',)
ai~bring~largest~worlds	('bring~ai~worlds~largest',)
industries~largest	('largest~industries',)
industries~largest~worlds	('worlds~largest~industries',)
ai~industries~largest~worlds	('ai~worlds~largest~industries',)
industries~nvidias	('industries~nvidias',)
industries~largest~nvidias	('largest~industries~nvidias',)
industries~largest~nvidias~worlds	('worlds~largest~industries~nvidias',)
ai~nvidias	('nvidias~ai', 'ai~nvidias')
ai~industries~nvidias	('industries~nvidias~ai',)
ai~industries~largest~nvidias	('largest~industries~nvidias~ai',)
expertise	('expertise',)
ai~expertise	('ai~expertise',)
ai~expertise~nvidias	('nvidias~ai~expertise',)
ai~expertise~industries~nvidias	('industries~nvidias~ai~expertise',)
scale	('scale',)
expertise~scale	('expertise~scale',)
ai~expertise~scale	('ai~expertise~scale',)
ai~expertise~nvidias~scale	('nvidias~ai~expertise~scale',)
helping~scale	('scale~helping',)
expertise~helping~scale	('expertise~scale~helping',)
ai~expertise~helping~scale	('ai~expertise~scale~helping',)
revolutionize	('revolutionize',)
helping~revolutionize	('helping~revolutionize',)
helping~revolutionize~scale	('scale~helping~revolutionize',)
expertise~helping~revolutionize~scale	('expertise~scale~helping~revolutionize',)
businesses	('businesses',)
businesses~revolutionize	('revolutionize~businesses',)
businesses~helping~revolutionize	('helping~revolutionize~businesses',)
businesses~helping~revolutionize~scale	('scale~helping~revolutionize~businesses',)
businesses~nvidia	('businesses~nvidia',)
businesses~nvidia~revolutionize	('revolutionize~businesses~nvidia',)
businesses~helping~nvidia~revolutionize	('helping~revolutionize~businesses~nvidia',)
software	('software',)
nvidia~software	('nvidia~software', 'software~nvidia')
businesses~nvidia~software	('businesses~nvidia~software',)
businesses~nvidia~revolutionize~software	('revolutionize~businesses~nvidia~software',)
services	('services',)
services~software	('software~services',)
nvidia~services~software	('nvidia~software~services',)
businesses~nvidia~services~software	('businesses~nvidia~software~services',)
enabling	('enabling',)
enabling~services	('services~enabling',)
enabling~services~software	('software~services~enabling',)
enabling~nvidia~services~software	('nvidia~software~services~enabling',)
enabling~worlds	('enabling~worlds',)
enabling~services~worlds	('services~enabling~worlds',)
enabling~services~software~worlds	('software~services~enabling~worlds',)
enterprises~worlds	('worlds~enterprises',)
enabling~enterprises~worlds	('enabling~worlds~enterprises',)
enabling~enterprises~services~worlds	('services~enabling~worlds~enterprises',)
enterprises~revolutionize	('enterprises~revolutionize',)
enterprises~revolutionize~worlds	('worlds~enterprises~revolutionize',)
enabling~enterprises~revolutionize~worlds	('enabling~worlds~enterprises~revolutionize',)
industries~revolutionize	('revolutionize~industries',)
enterprises~industries~revolutionize	('enterprises~revolutionize~industries',)
enterprises~industries~revolutionize~worlds	('worlds~enterprises~revolutionize~industries',)
ai~industries	('industries~ai',)
ai~industries~revolutionize	('revolutionize~industries~ai',)
ai~enterprises~industries~revolutionize	('enterprises~revolutionize~industries~ai',)
cost	('cost',)
ai~cost	('ai~cost',)
ai~cost~industries	('industries~ai~cost',)
ai~cost~industries~revolutionize	('revolutionize~industries~ai~cost',)
time-to-solution	('time-to-solution',)
cost~time-to-solution	('cost~time-to-solution',)
ai~cost~time-to-solution	('ai~cost~time-to-solution',)
ai~cost~industries~time-to-solution	('industries~ai~cost~time-to-solution',)
savings	('savings',)
savings~time-to-solution	('time-to-solution~savings',)
cost~savings~time-to-solution	('cost~time-to-solution~savings',)
ai~cost~savings~time-to-solution	('ai~cost~time-to-solution~savings',)
application	('application',)
application~savings	('savings~application',)
application~savings~time-to-solution	('time-to-solution~savings~application',)
application~cost~savings~time-to-solution	('cost~time-to-solution~savings~application',)
speed-ups	('speed-ups',)
application~speed-ups	('application~speed-ups',)
application~savings~speed-ups	('savings~application~speed-ups',)
application~savings~speed-ups~time-to-solution	('time-to-solution~savings~application~speed-ups',)
dividend	('dividend',)
dividend~speed-ups	('speed-ups~dividend',)
application~dividend~speed-ups	('application~speed-ups~dividend',)
application~dividend~savings~speed-ups	('savings~application~speed-ups~dividend',)
program	('program',)
dividend~program	('dividend~program',)
dividend~program~speed-ups	('speed-ups~dividend~program',)
application~dividend~program~speed-ups	('application~speed-ups~dividend~program',)
plan	('plan',)
plan~program	('program~plan',)
dividend~plan~program	('dividend~program~plan',)
dividend~plan~program~speed-ups	('speed-ups~dividend~program~plan',)
automotive	('automotive',)
automotive~plan	('plan~automotive',)
automotive~plan~program	('program~plan~automotive',)
automotive~dividend~plan~program	('dividend~program~plan~automotive',)
design	('design',)
automotive~design	('automotive~design',)
automotive~design~plan	('plan~automotive~design',)
automotive~design~plan~program	('program~plan~automotive~design',)
win	('win',)
design~win	('design~win',)
automotive~design~win	('automotive~design~win',)
automotive~design~plan~win	('plan~automotive~design~win',)
pipeline	('pipeline',)
pipeline~win	('win~pipeline',)
design~pipeline~win	('design~win~pipeline',)
automotive~design~pipeline~win	('automotive~design~win~pipeline',)
ramp	('ramp',)
pipeline~ramp	('pipeline~ramp',)
pipeline~ramp~win	('win~pipeline~ramp',)
design~pipeline~ramp~win	('design~win~pipeline~ramp',)
production	('production',)
production~ramp	('ramp~production',)
pipeline~production~ramp	('pipeline~ramp~production',)
pipeline~production~ramp~win	('win~pipeline~ramp~production',)
expectations	('expectations',)
expectations~production	('production~expectations',)
expectations~production~ramp	('ramp~production~expectations',)
expectations~pipeline~production~ramp	('pipeline~ramp~production~expectations',)
aim	('aim',)
aim~expectations	('expectations~aim',)
aim~expectations~production	('production~expectations~aim',)
aim~expectations~production~ramp	('ramp~production~expectations~aim',)
engage	('engage',)
aim~engage	('aim~engage',)
aim~engage~expectations	('expectations~aim~engage',)
aim~engage~expectations~production	('production~expectations~aim~engage',)
manufacturing	('manufacturing',)
engage~manufacturing	('engage~manufacturing',)
aim~engage~manufacturing	('aim~engage~manufacturing',)
aim~engage~expectations~manufacturing	('expectations~aim~engage~manufacturing',)
suppliers	('suppliers',)
manufacturing~suppliers	('manufacturing~suppliers',)
engage~manufacturing~suppliers	('engage~manufacturing~suppliers',)
aim~engage~manufacturing~suppliers	('aim~engage~manufacturing~suppliers',)
goal	('goal',)
goal~suppliers	('suppliers~goal',)
goal~manufacturing~suppliers	('manufacturing~suppliers~goal',)
engage~goal~manufacturing~suppliers	('engage~manufacturing~suppliers~goal',)
effecting	('effecting',)
effecting~goal	('goal~effecting',)
effecting~goal~suppliers	('suppliers~goal~effecting',)
effecting~goal~manufacturing~suppliers	('manufacturing~suppliers~goal~effecting',)
supplier	('supplier',)
effecting~supplier	('effecting~supplier',)
effecting~goal~supplier	('goal~effecting~supplier',)
effecting~goal~supplier~suppliers	('suppliers~goal~effecting~supplier',)
adoption	('adoption',)
adoption~supplier	('supplier~adoption',)
adoption~effecting~supplier	('effecting~supplier~adoption',)
adoption~effecting~goal~supplier	('goal~effecting~supplier~adoption',)
science-based	('science-based',)
adoption~science-based	('adoption~science-based',)
adoption~science-based~supplier	('supplier~adoption~science-based',)
adoption~effecting~science-based~supplier	('effecting~supplier~adoption~science-based',)
environmental	('environmental',)
environmental~science-based	('science-based~environmental',)
adoption~environmental~science-based	('adoption~science-based~environmental',)
adoption~environmental~science-based~supplier	('supplier~adoption~science-based~environmental',)
targets	('targets',)
environmental~targets	('environmental~targets',)
environmental~science-based~targets	('science-based~environmental~targets',)
adoption~environmental~science-based~targets	('adoption~science-based~environmental~targets',)
fiscal~targets	('targets~fiscal',)
environmental~fiscal~targets	('environmental~targets~fiscal',)
environmental~fiscal~science-based~targets	('science-based~environmental~targets~fiscal',)
2026	('2026',)
2026~fiscal	('fiscal~2026',)
2026~fiscal~targets	('targets~fiscal~2026',)
2026~environmental~fiscal~targets	('environmental~targets~fiscal~2026',)
2026~plan	('2026~plan',)
2026~fiscal~plan	('fiscal~2026~plan',)
2026~fiscal~plan~targets	('targets~fiscal~2026~plan',)
100%	('100%',)
100%~plan	('plan~100%',)
100%~2026~plan	('2026~plan~100%',)
100%~2026~fiscal~plan	('fiscal~2026~plan~100%',)
renewable	('renewable',)
100%~renewable	('100%~renewable',)
100%~plan~renewable	('plan~100%~renewable',)
100%~2026~plan~renewable	('2026~plan~100%~renewable',)
electricity	('electricity',)
electricity~renewable	('renewable~electricity', 'electricity~renewable')
100%~electricity~renewable	('100%~renewable~electricity',)
100%~electricity~plan~renewable	('plan~100%~renewable~electricity',)
operations	('operations',)
electricity~operations	('electricity~operations',)
electricity~operations~renewable	('renewable~electricity~operations',)
100%~electricity~operations~renewable	('100%~renewable~electricity~operations',)
data~operations	('operations~data',)
data~electricity~operations	('electricity~operations~data',)
data~electricity~operations~renewable	('renewable~electricity~operations~data',)
centers~data~operations	('operations~data~centers',)
centers~data~electricity~operations	('electricity~operations~data~centers',)
centers~fiscal	('centers~fiscal',)
centers~data~fiscal	('data~centers~fiscal',)
centers~data~fiscal~operations	('operations~data~centers~fiscal',)
2025	('2025',)
2025~fiscal	('fiscal~2025',)
2025~centers~fiscal	('centers~fiscal~2025',)
2025~centers~data~fiscal	('data~centers~fiscal~2025',)
annually	('annually',)
2025~annually	('2025~annually',)
2025~annually~fiscal	('fiscal~2025~annually',)
2025~annually~centers~fiscal	('centers~fiscal~2025~annually',)
thereafter	('thereafter',)
annually~thereafter	('annually~thereafter',)
2025~annually~thereafter	('2025~annually~thereafter',)
2025~annually~fiscal~thereafter	('fiscal~2025~annually~thereafter',)
forward-looking	('forward-looking',)
forward-looking~thereafter	('thereafter~forward-looking',)
annually~forward-looking~thereafter	('annually~thereafter~forward-looking',)
2025~annually~forward-looking~thereafter	('2025~annually~thereafter~forward-looking',)
forward-looking~statements	('forward-looking~statements',)
forward-looking~statements~thereafter	('thereafter~forward-looking~statements',)
annually~forward-looking~statements~thereafter	('annually~thereafter~forward-looking~statements',)
forward-looking~statements~statements	('statements~forward-looking~statements',)
forward-looking~forward-looking~statements~statements	('forward-looking~statements~forward-looking~statements',)
other	('other',)
other~statements	('statements~other', 'other~statements')
forward-looking~other~statements	('forward-looking~statements~other', 'statements~other~forward-looking', 'other~forward-looking~statements')
forward-looking~other~other~statements	('other~forward-looking~statements~other',)
forward-looking~other	('other~forward-looking',)
forward-looking~forward-looking~other~statements	('forward-looking~statements~other~forward-looking',)
forward-looking~other~statements~statements	('statements~other~forward-looking~statements',)
go	('go',)
go~statements	('statements~go',)
forward-looking~go~statements	('forward-looking~statements~go',)
forward-looking~go~other~statements	('other~forward-looking~statements~go',)
beyond	('beyond',)
beyond~go	('go~beyond',)
beyond~go~statements	('statements~go~beyond',)
beyond~forward-looking~go~statements	('forward-looking~statements~go~beyond',)
beyond~historical	('beyond~historical',)
beyond~go~historical	('go~beyond~historical',)
beyond~go~historical~statements	('statements~go~beyond~historical',)
facts	('facts',)
facts~historical	('historical~facts',)
beyond~facts~historical	('beyond~historical~facts',)
beyond~facts~go~historical	('go~beyond~historical~facts',)
made	('made',)
facts~made	('facts~made',)
facts~historical~made	('historical~facts~made',)
beyond~facts~historical~made	('beyond~historical~facts~made',)
made~presentation	('made~presentation',)
facts~made~presentation	('facts~made~presentation',)
facts~historical~made~presentation	('historical~facts~made~presentation',)
subject	('subject',)
presentation~subject	('presentation~subject',)
made~presentation~subject	('made~presentation~subject',)
facts~made~presentation~subject	('facts~made~presentation~subject',)
risks	('risks',)
risks~subject	('subject~risks',)
presentation~risks~subject	('presentation~subject~risks',)
made~presentation~risks~subject	('made~presentation~subject~risks',)
uncertainties	('uncertainties',)
risks~uncertainties	('risks~uncertainties',)
risks~subject~uncertainties	('subject~risks~uncertainties',)
presentation~risks~subject~uncertainties	('presentation~subject~risks~uncertainties',)
may	('may',)
may~uncertainties	('uncertainties~may',)
may~risks~uncertainties	('risks~uncertainties~may',)
may~risks~subject~uncertainties	('subject~risks~uncertainties~may',)
cause	('cause',)
cause~may	('may~cause',)
cause~may~uncertainties	('uncertainties~may~cause',)
cause~may~risks~uncertainties	('risks~uncertainties~may~cause',)
actual	('actual',)
actual~cause	('cause~actual',)
actual~cause~may	('may~cause~actual',)
actual~cause~may~uncertainties	('uncertainties~may~cause~actual',)
results	('results',)
actual~results	('actual~results',)
actual~cause~results	('cause~actual~results',)
actual~cause~may~results	('may~cause~actual~results',)
differ	('differ',)
differ~results	('results~differ',)
actual~differ~results	('actual~results~differ',)
actual~cause~differ~results	('cause~actual~results~differ',)
materially	('materially',)
differ~materially	('differ~materially',)
differ~materially~results	('results~differ~materially',)
actual~differ~materially~results	('actual~results~differ~materially',)
important	('important',)
factors	('factors',)
factors~important	('important~factors',)
factors~factors~important	('factors~important~factors',)
factors~factors~important~important	('important~factors~important~factors',)
could	('could',)
could~factors	('factors~could',)
could~factors~important	('important~factors~could',)
could~could~factors~important	('could~important~factors~could',)
cause~could	('could~cause',)
cause~could~factors	('factors~could~cause',)
cause~could~factors~important	('important~factors~could~cause',)
actual~cause~could	('could~cause~actual',)
actual~cause~could~factors	('factors~could~cause~actual',)
actual~cause~could~results	('could~cause~actual~results',)
include	('include',)
include~materially	('materially~include',)
differ~include~materially	('differ~materially~include',)
differ~include~materially~results	('results~differ~materially~include',)
global~include	('include~global',)
global~include~materially	('materially~include~global',)
differ~global~include~materially	('differ~materially~include~global',)
economic	('economic',)
economic~global	('global~economic',)
economic~global~include	('include~global~economic',)
economic~global~include~materially	('materially~include~global~economic',)
conditions	('conditions',)
conditions~economic	('economic~conditions',)
conditions~economic~global	('global~economic~conditions',)
conditions~economic~global~include	('include~global~economic~conditions',)
reliance	('reliance',)
conditions~reliance	('conditions~reliance',)
conditions~economic~reliance	('economic~conditions~reliance',)
conditions~economic~global~reliance	('global~economic~conditions~reliance',)
reliance~third	('reliance~third',)
conditions~reliance~third	('conditions~reliance~third',)
conditions~economic~reliance~third	('economic~conditions~reliance~third',)
parties	('parties',)
parties~third	('third~parties',)
parties~reliance~third	('reliance~third~parties',)
conditions~parties~reliance~third	('conditions~reliance~third~parties',)
manufacture	('manufacture',)
manufacture~parties	('parties~manufacture',)
manufacture~parties~third	('third~parties~manufacture',)
manufacture~parties~reliance~third	('reliance~third~parties~manufacture',)
assemble	('assemble',)
assemble~manufacture	('manufacture~assemble',)
assemble~manufacture~parties	('parties~manufacture~assemble',)
assemble~manufacture~parties~third	('third~parties~manufacture~assemble',)
package	('package',)
assemble~package	('assemble~package',)
assemble~manufacture~package	('manufacture~assemble~package',)
assemble~manufacture~package~parties	('parties~manufacture~assemble~package',)
test	('test',)
package~test	('package~test', 'test~package')
assemble~package~test	('assemble~package~test', 'assemble~test~package')
assemble~manufacture~package~test	('manufacture~assemble~package~test', 'manufacture~assemble~test~package')
products~test	('test~products',)
package~products~test	('package~test~products', 'test~package~products')
assemble~package~products~test	('assemble~package~test~products', 'assemble~test~package~products')
impact~products	('products~impact',)
impact~products~test	('test~products~impact',)
impact~package~products~test	('package~test~products~impact',)
technological	('technological',)
impact~technological	('impact~technological',)
impact~products~technological	('products~impact~technological',)
impact~products~technological~test	('test~products~impact~technological',)
development	('development',)
development~technological	('technological~development',)
development~impact~technological	('impact~technological~development',)
development~impact~products~technological	('products~impact~technological~development',)
competition	('competition',)
competition~development	('development~competition', 'competition~development')
competition~development~technological	('technological~development~competition',)
competition~development~impact~technological	('impact~technological~development~competition',)
competition~development~development	('development~competition~development',)
competition~development~development~technological	('technological~development~competition~development',)
development~new	('development~new',)
competition~development~new	('competition~development~new',)
competition~development~development~new	('development~competition~development~new',)
new~products	('new~products', 'products~new')
development~new~products	('development~new~products',)
competition~development~new~products	('competition~development~new~products',)
new~products~technologies	('new~products~technologies',)
development~new~products~technologies	('development~new~products~technologies',)
enhancements	('enhancements',)
enhancements~technologies	('technologies~enhancements',)
enhancements~products~technologies	('products~technologies~enhancements',)
enhancements~new~products~technologies	('new~products~technologies~enhancements',)
existing	('existing',)
enhancements~existing	('enhancements~existing',)
enhancements~existing~technologies	('technologies~enhancements~existing',)
enhancements~existing~products~technologies	('products~technologies~enhancements~existing',)
product	('product',)
existing~product	('existing~product',)
enhancements~existing~product	('enhancements~existing~product',)
enhancements~existing~product~technologies	('technologies~enhancements~existing~product', 'enhancements~existing~product~technologies')
product~technologies	('product~technologies',)
existing~product~technologies	('existing~product~technologies',)
market~technologies	('technologies~market',)
market~product~technologies	('product~technologies~market',)
existing~market~product~technologies	('existing~product~technologies~market',)
acceptance	('acceptance',)
acceptance~market	('market~acceptance',)
acceptance~market~technologies	('technologies~market~acceptance',)
acceptance~market~product~technologies	('product~technologies~market~acceptance',)
acceptance~products	('acceptance~products',)
acceptance~market~products	('market~acceptance~products',)
acceptance~market~products~technologies	('technologies~market~acceptance~products',)
partners	('partners',)
partners~products	('products~partners', 'partners~products')
acceptance~partners~products	('acceptance~products~partners',)
acceptance~market~partners~products	('market~acceptance~products~partners',)
partners~products~products	('products~partners~products',)
acceptance~partners~products~products	('acceptance~products~partners~products',)
design~products	('products~design', 'design~products')
design~partners~products	('partners~products~design',)
design~partners~products~products	('products~partners~products~design',)
design~manufacturing	('design~manufacturing',)
design~manufacturing~products	('products~design~manufacturing',)
design~manufacturing~partners~products	('partners~products~design~manufacturing',)
manufacturing~software	('manufacturing~software',)
design~manufacturing~software	('design~manufacturing~software',)
design~manufacturing~products~software	('products~design~manufacturing~software',)
defects	('defects',)
defects~software	('software~defects',)
defects~manufacturing~software	('manufacturing~software~defects',)
defects~design~manufacturing~software	('design~manufacturing~software~defects',)
changes	('changes',)
changes~defects	('defects~changes',)
changes~defects~software	('software~defects~changes',)
changes~defects~manufacturing~software	('manufacturing~software~defects~changes',)
consumer	('consumer',)
changes~consumer	('changes~consumer',)
changes~consumer~defects	('defects~changes~consumer',)
changes~consumer~defects~software	('software~defects~changes~consumer',)
preferences	('preferences',)
consumer~preferences	('consumer~preferences',)
changes~consumer~preferences	('changes~consumer~preferences',)
changes~consumer~defects~preferences	('defects~changes~consumer~preferences',)
demands	('demands',)
demands~preferences	('preferences~demands',)
consumer~demands~preferences	('consumer~preferences~demands',)
changes~consumer~demands~preferences	('changes~consumer~preferences~demands', 'consumer~preferences~demands~changes')
changes~demands	('demands~changes',)
changes~demands~preferences	('preferences~demands~changes',)
industry	('industry',)
changes~industry	('changes~industry', 'industry~changes')
changes~demands~industry	('demands~changes~industry',)
changes~demands~industry~preferences	('preferences~demands~changes~industry',)
standards	('standards',)
industry~standards	('industry~standards',)
changes~industry~standards	('changes~industry~standards',)
changes~demands~industry~standards	('demands~changes~industry~standards',)
interfaces	('interfaces',)
interfaces~standards	('standards~interfaces',)
industry~interfaces~standards	('industry~standards~interfaces',)
changes~industry~interfaces~standards	('changes~industry~standards~interfaces',)
unexpected	('unexpected',)
interfaces~unexpected	('interfaces~unexpected',)
interfaces~standards~unexpected	('standards~interfaces~unexpected',)
industry~interfaces~standards~unexpected	('industry~standards~interfaces~unexpected',)
loss	('loss',)
loss~unexpected	('unexpected~loss',)
interfaces~loss~unexpected	('interfaces~unexpected~loss',)
interfaces~loss~standards~unexpected	('standards~interfaces~unexpected~loss',)
loss~performance	('loss~performance',)
loss~performance~unexpected	('unexpected~loss~performance',)
interfaces~loss~performance~unexpected	('interfaces~unexpected~loss~performance',)
performance~products	('performance~products',)
loss~performance~products	('loss~performance~products',)
loss~performance~products~unexpected	('unexpected~loss~performance~products',)
performance~products~technologies	('performance~products~technologies',)
loss~performance~products~technologies	('loss~performance~products~technologies',)
when	('when',)
technologies~when	('technologies~when',)
products~technologies~when	('products~technologies~when',)
performance~products~technologies~when	('performance~products~technologies~when',)
integrated	('integrated',)
integrated~when	('when~integrated',)
integrated~technologies~when	('technologies~when~integrated',)
integrated~products~technologies~when	('products~technologies~when~integrated',)
integrated~systems	('integrated~systems',)
integrated~systems~when	('when~integrated~systems',)
integrated~systems~technologies~when	('technologies~when~integrated~systems',)
other~systems	('systems~other', 'other~systems')
integrated~other~systems	('integrated~systems~other',)
integrated~other~systems~when	('when~integrated~systems~other',)
factors~other	('other~factors',)
factors~other~systems	('systems~other~factors',)
factors~integrated~other~systems	('integrated~systems~other~factors',)
has~nvidia	('nvidia~has',)
has~has~nvidia	('has~nvidia~has',)
has~has~nvidia~nvidia	('nvidia~has~nvidia~has',)
based~has	('has~based',)
based~has~nvidia	('nvidia~has~based',)
based~based~has~nvidia	('based~nvidia~has~based',)
based~forward-looking	('based~forward-looking',)
based~forward-looking~has	('has~based~forward-looking',)
based~forward-looking~has~nvidia	('nvidia~has~based~forward-looking',)
based~forward-looking~statements	('based~forward-looking~statements', 'forward-looking~statements~based')
based~forward-looking~has~statements	('has~based~forward-looking~statements',)
largely~statements	('statements~largely',)
forward-looking~largely~statements	('forward-looking~statements~largely',)
based~forward-looking~largely~statements	('based~forward-looking~statements~largely',)
current	('current',)
current~largely	('largely~current',)
current~largely~statements	('statements~largely~current',)
current~forward-looking~largely~statements	('forward-looking~statements~largely~current',)
current~expectations	('current~expectations',)
current~expectations~largely	('largely~current~expectations',)
current~expectations~largely~statements	('statements~largely~current~expectations',)
projections	('projections',)
expectations~projections	('expectations~projections',)
current~expectations~projections	('current~expectations~projections',)
current~expectations~largely~projections	('largely~current~expectations~projections',)
future	('future',)
future~projections	('projections~future',)
expectations~future~projections	('expectations~projections~future',)
current~expectations~future~projections	('current~expectations~projections~future',)
events	('events',)
events~future	('future~events',)
events~future~projections	('projections~future~events',)
events~expectations~future~projections	('expectations~projections~future~events',)
trends	('trends',)
events~trends	('events~trends',)
events~future~trends	('future~events~trends',)
events~future~projections~trends	('projections~future~events~trends',)
believes	('believes',)
believes~trends	('trends~believes',)
believes~events~trends	('events~trends~believes',)
believes~events~future~trends	('future~events~trends~believes',)
believes~may	('believes~may',)
believes~may~trends	('trends~believes~may',)
believes~events~may~trends	('events~trends~believes~may',)
affect	('affect',)
affect~may	('may~affect',)
affect~believes~may	('believes~may~affect',)
affect~believes~may~trends	('trends~believes~may~affect',)
affect~financial	('affect~financial',)
affect~financial~may	('may~affect~financial',)
affect~believes~financial~may	('believes~may~affect~financial',)
condition	('condition',)
condition~financial	('financial~condition',)
affect~condition~financial	('affect~financial~condition',)
affect~condition~financial~may	('may~affect~financial~condition',)
condition~results	('condition~results',)
condition~financial~results	('financial~condition~results', 'results~financial~condition')
affect~condition~financial~results	('affect~financial~condition~results',)
operations~results	('results~operations', 'operations~results')
condition~operations~results	('condition~results~operations',)
condition~financial~operations~results	('financial~condition~results~operations', 'results~operations~financial~condition')
business	('business',)
business~operations	('operations~business', 'business~operations')
business~operations~results	('results~operations~business', 'business~results~operations')
business~condition~operations~results	('condition~results~operations~business',)
strategy	('strategy',)
business~strategy	('business~strategy',)
business~operations~strategy	('operations~business~strategy', 'business~strategy~operations')
business~operations~results~strategy	('results~operations~business~strategy',)
short-term	('short-term',)
short-term~strategy	('strategy~short-term',)
business~short-term~strategy	('business~strategy~short-term',)
business~operations~short-term~strategy	('operations~business~strategy~short-term',)
long-term	('long-term',)
long-term~short-term	('short-term~long-term',)
long-term~short-term~strategy	('strategy~short-term~long-term',)
business~long-term~short-term~strategy	('business~strategy~short-term~long-term', 'strategy~short-term~long-term~business')
business~long-term	('long-term~business',)
business~long-term~short-term	('short-term~long-term~business',)
business~long-term~operations	('long-term~business~operations',)
business~long-term~operations~short-term	('short-term~long-term~business~operations',)
objectives	('objectives',)
objectives~operations	('operations~objectives',)
business~objectives~operations	('business~operations~objectives',)
business~long-term~objectives~operations	('long-term~business~operations~objectives',)
financial~objectives	('objectives~financial',)
financial~objectives~operations	('operations~objectives~financial',)
business~financial~objectives~operations	('business~operations~objectives~financial',)
needs	('needs',)
financial~needs	('financial~needs',)
financial~needs~objectives	('objectives~financial~needs',)
financial~needs~objectives~operations	('operations~objectives~financial~needs',)
statements~subject	('statements~subject',)
forward-looking~statements~subject	('forward-looking~statements~subject',)
forward-looking~statements~subject~subject	('subject~forward-looking~statements~subject',)
number~subject	('subject~number',)
number~statements~subject	('statements~subject~number',)
forward-looking~number~statements~subject	('forward-looking~statements~subject~number',)
number~risks	('number~risks',)
number~risks~subject	('subject~number~risks',)
number~risks~statements~subject	('statements~subject~number~risks',)
number~risks~uncertainties	('number~risks~uncertainties',)
number~risks~subject~uncertainties	('subject~number~risks~uncertainties',)
not~uncertainties	('uncertainties~not',)
not~risks~uncertainties	('risks~uncertainties~not',)
not~number~risks~uncertainties	('number~risks~uncertainties~not',)
rely	('rely',)
not~rely	('not~rely',)
not~rely~uncertainties	('uncertainties~not~rely',)
not~rely~risks~uncertainties	('risks~uncertainties~not~rely',)
upon	('upon',)
rely~upon	('rely~upon', 'upon~rely')
not~rely~upon	('not~rely~upon',)
not~rely~uncertainties~upon	('uncertainties~not~rely~upon',)
forward-looking~upon	('upon~forward-looking',)
forward-looking~rely~upon	('rely~upon~forward-looking',)
forward-looking~not~rely~upon	('not~rely~upon~forward-looking',)
forward-looking~statements~upon	('upon~forward-looking~statements',)
forward-looking~rely~statements~upon	('rely~upon~forward-looking~statements',)
predictions	('predictions',)
predictions~statements	('statements~predictions',)
forward-looking~predictions~statements	('forward-looking~statements~predictions',)
forward-looking~predictions~statements~upon	('upon~forward-looking~statements~predictions',)
future~predictions	('predictions~future',)
future~predictions~statements	('statements~predictions~future',)
forward-looking~future~predictions~statements	('forward-looking~statements~predictions~future',)
events~future~predictions	('predictions~future~events',)
events~future~predictions~statements	('statements~predictions~future~events',)
events~events~future	('events~future~events',)
events~events~future~future	('future~events~future~events',)
events~future~trends~trends	('trends~future~events~trends',)
discussed	('discussed',)
discussed~trends	('trends~discussed',)
discussed~events~trends	('events~trends~discussed',)
discussed~events~future~trends	('future~events~trends~discussed',)
discussed~presentation	('discussed~presentation',)
discussed~presentation~trends	('trends~discussed~presentation',)
discussed~events~presentation~trends	('events~trends~discussed~presentation',)
may~presentation	('presentation~may',)
discussed~may~presentation	('discussed~presentation~may',)
discussed~may~presentation~trends	('trends~discussed~presentation~may',)
may~not	('may~not',)
may~not~presentation	('presentation~may~not',)
discussed~may~not~presentation	('discussed~presentation~may~not',)
occur	('occur',)
not~occur	('not~occur',)
may~not~occur	('may~not~occur',)
may~not~occur~presentation	('presentation~may~not~occur',)
actual~occur	('occur~actual',)
actual~not~occur	('not~occur~actual',)
actual~may~not~occur	('may~not~occur~actual',)
actual~occur~results	('occur~actual~results',)
actual~not~occur~results	('not~occur~actual~results',)
could~results	('results~could',)
actual~could~results	('actual~results~could',)
actual~could~occur~results	('occur~actual~results~could',)
could~differ	('could~differ',)
could~differ~results	('results~could~differ',)
actual~could~differ~results	('actual~results~could~differ',)
could~differ~materially	('could~differ~materially',)
could~differ~materially~results	('results~could~differ~materially',)
adversely	('adversely',)
adversely~materially	('materially~adversely',)
adversely~differ~materially	('differ~materially~adversely',)
adversely~could~differ~materially	('could~differ~materially~adversely',)
those	('those',)
adversely~those	('adversely~those',)
adversely~materially~those	('materially~adversely~those',)
adversely~differ~materially~those	('differ~materially~adversely~those',)
anticipated	('anticipated',)
anticipated~those	('those~anticipated',)
adversely~anticipated~those	('adversely~those~anticipated',)
adversely~anticipated~materially~those	('materially~adversely~those~anticipated',)
implied	('implied',)
anticipated~implied	('anticipated~implied',)
anticipated~implied~those	('those~anticipated~implied',)
adversely~anticipated~implied~those	('adversely~those~anticipated~implied',)
forward-looking~implied	('implied~forward-looking',)
anticipated~forward-looking~implied	('anticipated~implied~forward-looking',)
anticipated~forward-looking~implied~those	('those~anticipated~implied~forward-looking',)
forward-looking~implied~statements	('implied~forward-looking~statements',)
anticipated~forward-looking~implied~statements	('anticipated~implied~forward-looking~statements',)
although	('although',)
although~nvidia	('although~nvidia', 'nvidia~although')
although~nvidia~nvidia	('nvidia~although~nvidia',)
although~although~nvidia~nvidia	('although~nvidia~although~nvidia',)
believes~nvidia	('nvidia~believes',)
although~believes~nvidia	('although~nvidia~believes',)
although~believes~believes~nvidia	('believes~although~nvidia~believes',)
believes~expectations	('believes~expectations',)
believes~expectations~nvidia	('nvidia~believes~expectations',)
although~believes~expectations~nvidia	('although~nvidia~believes~expectations',)
reflected	('reflected',)
expectations~reflected	('expectations~reflected',)
believes~expectations~reflected	('believes~expectations~reflected',)
believes~expectations~nvidia~reflected	('nvidia~believes~expectations~reflected',)
forward-looking~reflected	('reflected~forward-looking',)
expectations~forward-looking~reflected	('expectations~reflected~forward-looking',)
believes~expectations~forward-looking~reflected	('believes~expectations~reflected~forward-looking',)
forward-looking~reflected~statements	('reflected~forward-looking~statements',)
expectations~forward-looking~reflected~statements	('expectations~reflected~forward-looking~statements',)
reasonable	('reasonable',)
reasonable~statements	('statements~reasonable',)
forward-looking~reasonable~statements	('forward-looking~statements~reasonable',)
forward-looking~reasonable~reflected~statements	('reflected~forward-looking~statements~reasonable',)
company	('company',)
company~reasonable	('reasonable~company',)
company~reasonable~statements	('statements~reasonable~company',)
company~forward-looking~reasonable~statements	('forward-looking~statements~reasonable~company',)
cannot	('cannot',)
cannot~company	('company~cannot',)
cannot~company~reasonable	('reasonable~company~cannot',)
cannot~company~reasonable~statements	('statements~reasonable~company~cannot',)
guarantee	('guarantee',)
cannot~guarantee	('cannot~guarantee',)
cannot~company~guarantee	('company~cannot~guarantee',)
cannot~company~guarantee~reasonable	('reasonable~company~cannot~guarantee',)
future~guarantee	('guarantee~future',)
cannot~future~guarantee	('cannot~guarantee~future',)
cannot~company~future~guarantee	('company~cannot~guarantee~future',)
future~results	('future~results', 'results~future')
future~guarantee~results	('guarantee~future~results',)
cannot~future~guarantee~results	('cannot~guarantee~future~results',)
levels	('levels',)
levels~results	('results~levels',)
future~levels~results	('future~results~levels',)
future~guarantee~levels~results	('guarantee~future~results~levels',)
activity	('activity',)
activity~levels	('levels~activity',)
activity~levels~results	('results~levels~activity',)
activity~future~levels~results	('future~results~levels~activity',)
activity~performance	('activity~performance',)
activity~levels~performance	('levels~activity~performance',)
activity~levels~performance~results	('results~levels~activity~performance',)
achievements	('achievements',)
achievements~performance	('performance~achievements',)
achievements~activity~performance	('activity~performance~achievements',)
achievements~activity~levels~performance	('levels~activity~performance~achievements',)
achievements~events	('achievements~events',)
achievements~events~performance	('performance~achievements~events',)
achievements~activity~events~performance	('activity~performance~achievements~events',)
circumstances	('circumstances',)
circumstances~events	('events~circumstances',)
achievements~circumstances~events	('achievements~events~circumstances',)
achievements~circumstances~events~performance	('performance~achievements~events~circumstances',)
circumstances~reflected	('circumstances~reflected',)
circumstances~events~reflected	('events~circumstances~reflected',)
achievements~circumstances~events~reflected	('achievements~events~circumstances~reflected',)
circumstances~forward-looking~reflected	('circumstances~reflected~forward-looking',)
circumstances~events~forward-looking~reflected	('events~circumstances~reflected~forward-looking',)
circumstances~forward-looking~reflected~statements	('circumstances~reflected~forward-looking~statements',)
occur~statements	('statements~occur',)
forward-looking~occur~statements	('forward-looking~statements~occur',)
forward-looking~occur~reflected~statements	('reflected~forward-looking~statements~occur',)
required	('required',)
except~required	('except~required',)
except~required~required	('required~except~required',)
except~except~required~required	('except~required~except~required',)
law~required	('required~law',)
except~law~required	('except~required~law',)
except~law~law~required	('law~except~required~law',)
law~nvidia	('law~nvidia',)
law~nvidia~required	('required~law~nvidia',)
except~law~nvidia~required	('except~required~law~nvidia',)
disclaims	('disclaims',)
disclaims~nvidia	('nvidia~disclaims',)
disclaims~law~nvidia	('law~nvidia~disclaims',)
disclaims~law~nvidia~required	('required~law~nvidia~disclaims',)
obligation	('obligation',)
disclaims~obligation	('disclaims~obligation',)
disclaims~nvidia~obligation	('nvidia~disclaims~obligation',)
disclaims~law~nvidia~obligation	('law~nvidia~disclaims~obligation',)
obligation~update	('obligation~update',)
disclaims~obligation~update	('disclaims~obligation~update',)
disclaims~nvidia~obligation~update	('nvidia~disclaims~obligation~update',)
forward-looking~update	('update~forward-looking',)
forward-looking~obligation~update	('obligation~update~forward-looking',)
disclaims~forward-looking~obligation~update	('disclaims~obligation~update~forward-looking',)
forward-looking~statements~update	('update~forward-looking~statements',)
forward-looking~obligation~statements~update	('obligation~update~forward-looking~statements',)
reflect	('reflect',)
reflect~statements	('statements~reflect',)
forward-looking~reflect~statements	('forward-looking~statements~reflect',)
forward-looking~reflect~statements~update	('update~forward-looking~statements~reflect',)
future~reflect	('reflect~future',)
future~reflect~statements	('statements~reflect~future',)
forward-looking~future~reflect~statements	('forward-looking~statements~reflect~future',)
events~future~reflect	('reflect~future~events',)
events~future~reflect~statements	('statements~reflect~future~events',)
circumstances~events~future	('future~events~circumstances',)
circumstances~events~future~reflect	('reflect~future~events~circumstances',)
complete	('complete',)
discussion	('discussion',)
complete~discussion	('complete~discussion',)
complete~discussion~discussion	('discussion~complete~discussion',)
complete~complete~discussion~discussion	('complete~discussion~complete~discussion',)
discussion~factors	('discussion~factors', 'factors~discussion')
complete~discussion~factors	('complete~discussion~factors',)
complete~discussion~factors~factors	('factors~complete~discussion~factors',)
could~discussion~factors	('discussion~factors~could',)
complete~could~discussion~factors	('complete~discussion~factors~could',)
could~materially	('could~materially',)
could~factors~materially	('factors~could~materially',)
could~discussion~factors~materially	('discussion~factors~could~materially',)
affect~materially	('materially~affect',)
affect~could~materially	('could~materially~affect',)
affect~could~factors~materially	('factors~could~materially~affect',)
affect~financial~materially	('materially~affect~financial',)
affect~could~financial~materially	('could~materially~affect~financial',)
financial~results	('financial~results', 'results~financial')
affect~financial~results	('affect~financial~results',)
affect~financial~materially~results	('materially~affect~financial~results',)
financial~operations~results	('financial~results~operations', 'results~operations~financial', 'operations~financial~results')
affect~financial~operations~results	('affect~financial~results~operations',)
please	('please',)
operations~please	('operations~please',)
operations~please~results	('results~operations~please',)
financial~operations~please~results	('financial~results~operations~please',)
refer	('refer',)
please~refer	('please~refer',)
operations~please~refer	('operations~please~refer',)
operations~please~refer~results	('results~operations~please~refer',)
reports	('reports',)
refer~reports	('refer~reports',)
please~refer~reports	('please~refer~reports',)
operations~please~refer~reports	('operations~please~refer~reports',)
file	('file',)
file~reports	('reports~file', 'file~reports')
file~refer~reports	('refer~reports~file',)
file~please~refer~reports	('please~refer~reports~file',)
file~time	('file~time',)
file~reports~time	('reports~file~time',)
file~refer~reports~time	('refer~reports~file~time',)
time~time	('time~time',)
file~time~time	('file~time~time',)
file~reports~time~time	('reports~file~time~time',)
sec	('sec',)
sec~time	('time~sec',)
sec~time~time	('time~time~sec',)
file~sec~time~time	('file~time~time~sec',)
including~sec	('sec~including',)
including~sec~time	('time~sec~including',)
including~sec~time~time	('time~time~sec~including',)
including~most	('including~most',)
including~most~sec	('sec~including~most',)
including~most~sec~time	('time~sec~including~most',)
recent	('recent',)
most~recent	('most~recent',)
including~most~recent	('including~most~recent',)
including~most~recent~sec	('sec~including~most~recent',)
annual	('annual',)
annual~recent	('recent~annual',)
annual~most~recent	('most~recent~annual',)
annual~including~most~recent	('including~most~recent~annual',)
report	('report',)
annual~report	('annual~report',)
annual~recent~report	('recent~annual~report',)
annual~most~recent~report	('most~recent~annual~report',)
form	('form',)
form~report	('report~form',)
annual~form~report	('annual~report~form',)
annual~form~recent~report	('recent~annual~report~form',)
10-k	('10-k',)
10-k~form	('form~10-k',)
10-k~form~report	('report~form~10-k',)
10-k~annual~form~report	('annual~report~form~10-k', 'report~form~10-k~annual')
quarterly	('quarterly',)
10-k~quarterly	('10-k~quarterly',)
10-k~form~quarterly	('form~10-k~quarterly',)
10-k~form~quarterly~report	('report~form~10-k~quarterly',)
quarterly~reports	('quarterly~reports',)
10-k~quarterly~reports	('10-k~quarterly~reports',)
10-k~form~quarterly~reports	('form~10-k~quarterly~reports', '10-k~quarterly~reports~form', 'reports~form~10-k~quarterly')
form~reports	('reports~form',)
form~quarterly~reports	('quarterly~reports~form',)
10-q	('10-q',)
10-q~form	('form~10-q', '10-q~form')
10-q~form~reports	('reports~form~10-q',)
10-q~form~quarterly~reports	('quarterly~reports~form~10-q',)
10-q~current	('10-q~current',)
10-q~current~form	('form~10-q~current',)
10-q~current~form~reports	('reports~form~10-q~current', 'form~10-q~current~reports', '10-q~current~reports~form')
current~reports	('current~reports',)
10-q~current~reports	('10-q~current~reports',)
current~form~reports	('current~reports~form',)
8-k	('8-k',)
8-k~form	('form~8-k',)
8-k~form~reports	('reports~form~8-k',)
8-k~current~form~reports	('current~reports~form~8-k',)
copies	('copies',)
copies~reports	('copies~reports',)
copies~reports~reports	('reports~copies~reports',)
copies~copies~reports~reports	('copies~reports~copies~reports',)
copies~file~reports	('copies~reports~file',)
copies~file~file~reports	('file~copies~reports~file',)
file~sec	('file~sec',)
file~reports~sec	('reports~file~sec',)
copies~file~reports~sec	('copies~reports~file~sec',)
posted	('posted',)
posted~sec	('sec~posted',)
file~posted~sec	('file~sec~posted',)
file~posted~reports~sec	('reports~file~sec~posted',)
website	('website',)
posted~website	('posted~website',)
posted~sec~website	('sec~posted~website',)
file~posted~sec~website	('file~sec~posted~website',)
available	('available',)
available~website	('website~available', 'available~website')
available~posted~website	('posted~website~available',)
available~posted~sec~website	('sec~posted~website~available',)
available~nvidia	('available~nvidia',)
available~nvidia~website	('website~available~nvidia',)
available~nvidia~posted~website	('posted~website~available~nvidia',)
without	('without',)
nvidia~without	('nvidia~without',)
available~nvidia~without	('available~nvidia~without',)
available~nvidia~website~without	('website~available~nvidia~without',)
charge	('charge',)
charge~without	('without~charge',)
charge~nvidia~without	('nvidia~without~charge',)
available~charge~nvidia~without	('available~nvidia~without~charge',)
many	('many',)
many~products	('many~products',)
many~products~products	('products~many~products',)
many~many~products~products	('many~products~many~products',)
features~products	('products~features',)
features~many~products	('many~products~features',)
features~features~many~products	('features~many~products~features',)
described	('described',)
described~features	('features~described',)
described~features~products	('products~features~described',)
described~features~many~products	('many~products~features~described',)
described~herein	('described~herein',)
described~features~herein	('features~described~herein',)
described~features~herein~products	('products~features~described~herein',)
remain	('remain',)
herein~remain	('herein~remain',)
described~herein~remain	('described~herein~remain',)
described~features~herein~remain	('features~described~herein~remain',)
stages	('stages',)
remain~stages	('remain~stages',)
herein~remain~stages	('herein~remain~stages',)
described~herein~remain~stages	('described~herein~remain~stages',)
offered	('offered',)
offered~stages	('stages~offered',)
offered~remain~stages	('remain~stages~offered',)
herein~offered~remain~stages	('herein~remain~stages~offered',)
when-and-if-available	('when-and-if-available',)
offered~when-and-if-available	('offered~when-and-if-available',)
offered~stages~when-and-if-available	('stages~offered~when-and-if-available',)
offered~remain~stages~when-and-if-available	('remain~stages~offered~when-and-if-available',)
basis	('basis',)
basis~when-and-if-available	('when-and-if-available~basis',)
basis~offered~when-and-if-available	('offered~when-and-if-available~basis',)
basis~offered~stages~when-and-if-available	('stages~offered~when-and-if-available~basis',)
not~statements	('statements~not',)
not~not~statements	('not~statements~not',)
not~not~statements~statements	('statements~not~statements~not',)
intended	('intended',)
intended~not	('not~intended', 'intended~not')
intended~not~statements	('statements~not~intended',)
intended~intended~not~statements	('intended~statements~not~intended',)
intended~not~not	('not~intended~not',)
intended~not~not~statements	('statements~not~intended~not',)
interpreted	('interpreted',)
interpreted~not	('not~interpreted',)
intended~interpreted~not	('intended~not~interpreted',)
intended~interpreted~not~not	('not~intended~not~interpreted',)
commitment	('commitment',)
commitment~interpreted	('interpreted~commitment',)
commitment~interpreted~not	('not~interpreted~commitment',)
commitment~intended~interpreted~not	('intended~not~interpreted~commitment',)
promise	('promise',)
commitment~promise	('commitment~promise',)
commitment~interpreted~promise	('interpreted~commitment~promise',)
commitment~interpreted~not~promise	('not~interpreted~commitment~promise',)
legal	('legal',)
legal~promise	('promise~legal',)
commitment~legal~promise	('commitment~promise~legal',)
commitment~interpreted~legal~promise	('interpreted~commitment~promise~legal',)
legal~obligation	('legal~obligation',)
legal~obligation~promise	('promise~legal~obligation',)
commitment~legal~obligation~promise	('commitment~promise~legal~obligation',)
development~obligation	('obligation~development',)
development~legal~obligation	('legal~obligation~development',)
development~legal~obligation~promise	('promise~legal~obligation~development',)
release	('release',)
development~release	('development~release',)
development~obligation~release	('obligation~development~release',)
development~legal~obligation~release	('legal~obligation~development~release',)
release~timing	('release~timing',)
development~release~timing	('development~release~timing',)
development~obligation~release~timing	('obligation~development~release~timing',)
features~release~timing	('release~timing~features',)
development~features~release~timing	('development~release~timing~features',)
functionalities	('functionalities',)
features~functionalities	('features~functionalities',)
features~functionalities~timing	('timing~features~functionalities',)
features~functionalities~release~timing	('release~timing~features~functionalities',)
described~functionalities	('functionalities~described',)
described~features~functionalities	('features~functionalities~described',)
described~features~functionalities~timing	('timing~features~functionalities~described',)
described~products	('described~products',)
described~functionalities~products	('functionalities~described~products',)
described~features~functionalities~products	('features~functionalities~described~products',)
products~subject	('products~subject',)
described~products~subject	('described~products~subject',)
described~functionalities~products~subject	('functionalities~described~products~subject',)
change	('change',)
change~subject	('subject~change',)
change~products~subject	('products~subject~change',)
change~described~products~subject	('described~products~subject~change',)
remains	('remains',)
change~remains	('change~remains',)
change~remains~subject	('subject~change~remains',)
change~products~remains~subject	('products~subject~change~remains',)
sole	('sole',)
remains~sole	('remains~sole',)
change~remains~sole	('change~remains~sole',)
change~remains~sole~subject	('subject~change~remains~sole',)
discretion	('discretion',)
discretion~sole	('sole~discretion',)
discretion~remains~sole	('remains~sole~discretion',)
change~discretion~remains~sole	('change~remains~sole~discretion',)
discretion~nvidia	('discretion~nvidia',)
discretion~nvidia~sole	('sole~discretion~nvidia',)
discretion~nvidia~remains~sole	('remains~sole~discretion~nvidia',)
have	('have',)
have~nvidia	('nvidia~have', 'have~nvidia')
have~have~nvidia	('have~nvidia~have',)
have~have~nvidia~nvidia	('nvidia~have~nvidia~have',)
no	('no',)
have~no	('have~no',)
have~no~nvidia	('nvidia~have~no',)
have~no~no~nvidia	('no~nvidia~have~no',)
liability	('liability',)
liability~no	('no~liability',)
have~liability~no	('have~no~liability',)
have~liability~no~nvidia	('nvidia~have~no~liability',)
failure	('failure',)
failure~liability	('liability~failure',)
failure~liability~no	('no~liability~failure',)
failure~have~liability~no	('have~no~liability~failure',)
deliver	('deliver',)
deliver~failure	('failure~deliver',)
deliver~failure~liability	('liability~failure~deliver',)
deliver~failure~liability~no	('no~liability~failure~deliver',)
delay	('delay',)
delay~deliver	('deliver~delay',)
delay~deliver~failure	('failure~deliver~delay',)
delay~deliver~failure~liability	('liability~failure~deliver~delay',)
delivery	('delivery',)
delay~delivery	('delay~delivery',)
delay~deliver~delivery	('deliver~delay~delivery',)
delay~deliver~delivery~failure	('failure~deliver~delay~delivery',)
delivery~products	('delivery~products',)
delay~delivery~products	('delay~delivery~products',)
delay~deliver~delivery~products	('deliver~delay~delivery~products',)
delivery~features~products	('delivery~products~features',)
delay~delivery~features~products	('delay~delivery~products~features',)
functions	('functions',)
features~functions	('features~functions',)
features~functions~products	('products~features~functions',)
delivery~features~functions~products	('delivery~products~features~functions',)
set	('set',)
functions~set	('functions~set',)
features~functions~set	('features~functions~set',)
features~functions~products~set	('products~features~functions~set',)
forth	('forth',)
forth~set	('set~forth',)
forth~functions~set	('functions~set~forth',)
features~forth~functions~set	('features~functions~set~forth',)
forth~herein	('forth~herein',)
forth~herein~set	('set~forth~herein',)
forth~functions~herein~set	('functions~set~forth~herein',)
uses	('uses',)
nvidia~uses	('nvidia~uses',)
nvidia~uses~uses	('uses~nvidia~uses',)
nvidia~nvidia~uses~uses	('nvidia~uses~nvidia~uses',)
certain~uses	('uses~certain',)
certain~nvidia~uses	('nvidia~uses~certain',)
certain~certain~nvidia~uses	('certain~nvidia~uses~certain',)
non-gaap	('non-gaap',)
certain~non-gaap	('certain~non-gaap',)
certain~non-gaap~uses	('uses~certain~non-gaap',)
certain~non-gaap~nvidia~uses	('nvidia~uses~certain~non-gaap',)
measures	('measures',)
measures~non-gaap	('non-gaap~measures',)
certain~measures~non-gaap	('certain~non-gaap~measures',)
certain~measures~non-gaap~uses	('uses~certain~non-gaap~measures',)
measures~presentation	('measures~presentation',)
measures~non-gaap~presentation	('non-gaap~measures~presentation',)
certain~measures~non-gaap~presentation	('certain~non-gaap~measures~presentation',)
including~measures~presentation	('measures~presentation~including',)
including~measures~non-gaap~presentation	('non-gaap~measures~presentation~including', 'measures~presentation~including~non-gaap')
including~non-gaap	('including~non-gaap',)
including~non-gaap~presentation	('presentation~including~non-gaap',)
gross	('gross',)
gross~non-gaap	('non-gaap~gross',)
gross~including~non-gaap	('including~non-gaap~gross',)
gross~including~non-gaap~presentation	('presentation~including~non-gaap~gross',)
profit	('profit',)
gross~profit	('gross~profit', 'profit~gross')
gross~non-gaap~profit	('non-gaap~gross~profit', 'gross~profit~non-gaap', 'profit~non-gaap~gross')
gross~including~non-gaap~profit	('including~non-gaap~gross~profit',)
non-gaap~profit	('profit~non-gaap',)
gross~non-gaap~non-gaap~profit	('non-gaap~gross~profit~non-gaap',)
gross~gross~non-gaap~profit	('gross~profit~non-gaap~gross',)
margin	('margin',)
gross~margin	('gross~margin', 'margin~gross')
gross~margin~non-gaap	('non-gaap~gross~margin', 'gross~margin~non-gaap')
gross~margin~non-gaap~profit	('profit~non-gaap~gross~margin',)
margin~non-gaap	('margin~non-gaap',)
gross~margin~non-gaap~non-gaap	('non-gaap~gross~margin~non-gaap',)
operating	('operating',)
non-gaap~operating	('non-gaap~operating',)
margin~non-gaap~operating	('margin~non-gaap~operating', 'operating~margin~non-gaap')
gross~margin~non-gaap~operating	('gross~margin~non-gaap~operating',)
expenses	('expenses',)
expenses~operating	('operating~expenses',)
expenses~non-gaap~operating	('non-gaap~operating~expenses', 'operating~expenses~non-gaap', 'expenses~non-gaap~operating')
expenses~margin~non-gaap~operating	('margin~non-gaap~operating~expenses',)
expenses~non-gaap	('expenses~non-gaap',)
expenses~non-gaap~non-gaap~operating	('non-gaap~operating~expenses~non-gaap',)
expenses~non-gaap~operating~operating	('operating~expenses~non-gaap~operating',)
income	('income',)
income~operating	('operating~income', 'income~operating')
income~non-gaap~operating	('non-gaap~operating~income', 'operating~income~non-gaap', 'income~non-gaap~operating')
expenses~income~non-gaap~operating	('expenses~non-gaap~operating~income',)
non-	('non-',)
income~non-	('income~non-',)
income~non-~operating	('operating~income~non-',)
income~non-~non-gaap~operating	('non-gaap~operating~income~non-',)
gaap	('gaap',)
gaap~non-	('non-~gaap',)
gaap~income~non-	('income~non-~gaap',)
gaap~income~non-~operating	('operating~income~non-~gaap', 'income~non-~gaap~operating', 'non-~gaap~operating~income', 'gaap~operating~income~non-')
gaap~operating	('gaap~operating',)
gaap~non-~operating	('non-~gaap~operating',)
margin~operating	('operating~margin', 'margin~operating')
gaap~margin~operating	('gaap~operating~margin',)
gaap~margin~non-~operating	('non-~gaap~operating~margin',)
gaap~margin~non-gaap~operating	('gaap~operating~margin~non-gaap',)
net	('net',)
net~non-gaap	('non-gaap~net',)
margin~net~non-gaap	('margin~non-gaap~net',)
margin~net~non-gaap~operating	('operating~margin~non-gaap~net',)
income~net	('net~income', 'income~net')
income~net~non-gaap	('non-gaap~net~income', 'net~income~non-gaap')
income~margin~net~non-gaap	('margin~non-gaap~net~income',)
income~non-gaap	('income~non-gaap',)
income~net~non-gaap~non-gaap	('non-gaap~net~income~non-gaap',)
diluted	('diluted',)
diluted~non-gaap	('non-gaap~diluted',)
diluted~income~non-gaap	('income~non-gaap~diluted',)
diluted~income~net~non-gaap	('net~income~non-gaap~diluted',)
earnings	('earnings',)
diluted~earnings	('diluted~earnings',)
diluted~earnings~non-gaap	('non-gaap~diluted~earnings',)
diluted~earnings~income~non-gaap	('income~non-gaap~diluted~earnings',)
per	('per',)
earnings~per	('earnings~per',)
diluted~earnings~per	('diluted~earnings~per',)
diluted~earnings~non-gaap~per	('non-gaap~diluted~earnings~per',)
share	('share',)
per~share	('per~share',)
earnings~per~share	('earnings~per~share',)
diluted~earnings~per~share	('diluted~earnings~per~share',)
free	('free',)
free~share	('share~free',)
free~per~share	('per~share~free',)
earnings~free~per~share	('earnings~per~share~free',)
cash	('cash',)
cash~free	('free~cash',)
cash~free~share	('share~free~cash',)
cash~free~per~share	('per~share~free~cash',)
flow	('flow',)
cash~flow	('cash~flow',)
cash~flow~free	('free~cash~flow',)
cash~flow~free~share	('share~free~cash~flow',)
believes~believes~nvidia	('believes~nvidia~believes',)
believes~believes~nvidia~nvidia	('nvidia~believes~nvidia~believes',)
believes~presentation	('believes~presentation',)
believes~nvidia~presentation	('nvidia~believes~presentation',)
believes~nvidia~presentation~presentation	('presentation~nvidia~believes~presentation',)
non-gaap~presentation	('presentation~non-gaap',)
believes~non-gaap~presentation	('believes~presentation~non-gaap',)
believes~non-gaap~nvidia~presentation	('nvidia~believes~presentation~non-gaap',)
financial~non-gaap	('non-gaap~financial',)
financial~non-gaap~presentation	('presentation~non-gaap~financial',)
believes~financial~non-gaap~presentation	('believes~presentation~non-gaap~financial',)
financial~measures	('financial~measures',)
financial~measures~non-gaap	('non-gaap~financial~measures',)
financial~measures~non-gaap~presentation	('presentation~non-gaap~financial~measures',)
enhances	('enhances',)
enhances~measures	('measures~enhances',)
enhances~financial~measures	('financial~measures~enhances',)
enhances~financial~measures~non-gaap	('non-gaap~financial~measures~enhances',)
investors	('investors',)
enhances~investors	('enhances~investors',)
enhances~investors~measures	('measures~enhances~investors',)
enhances~financial~investors~measures	('financial~measures~enhances~investors',)
investors~overall	('investors~overall',)
enhances~investors~overall	('enhances~investors~overall',)
enhances~investors~measures~overall	('measures~enhances~investors~overall',)
understanding	('understanding',)
overall~understanding	('overall~understanding',)
investors~overall~understanding	('investors~overall~understanding',)
enhances~investors~overall~understanding	('enhances~investors~overall~understanding',)
companys	('companys',)
companys~understanding	('understanding~companys',)
companys~overall~understanding	('overall~understanding~companys',)
companys~investors~overall~understanding	('investors~overall~understanding~companys',)
companys~historical	('companys~historical',)
companys~historical~understanding	('understanding~companys~historical',)
companys~historical~overall~understanding	('overall~understanding~companys~historical',)
financial~historical	('historical~financial',)
companys~financial~historical	('companys~historical~financial',)
companys~financial~historical~understanding	('understanding~companys~historical~financial',)
financial~performance	('financial~performance', 'performance~financial')
financial~historical~performance	('historical~financial~performance',)
companys~financial~historical~performance	('companys~historical~financial~performance',)
companys~presentation	('presentation~companys',)
companys~companys~presentation	('companys~presentation~companys',)
companys~companys~presentation~presentation	('presentation~companys~presentation~companys',)
companys~non-gaap	('companys~non-gaap',)
companys~non-gaap~presentation	('presentation~companys~non-gaap',)
companys~non-gaap~non-gaap~presentation	('non-gaap~presentation~companys~non-gaap',)
companys~financial~non-gaap	('companys~non-gaap~financial',)
companys~financial~non-gaap~presentation	('presentation~companys~non-gaap~financial',)
companys~financial~measures~non-gaap	('companys~non-gaap~financial~measures',)
measures~not	('measures~not',)
financial~measures~not	('financial~measures~not',)
financial~measures~non-gaap~not	('non-gaap~financial~measures~not',)
meant	('meant',)
meant~not	('not~meant',)
meant~measures~not	('measures~not~meant',)
financial~meant~measures~not	('financial~measures~not~meant',)
isolation	('isolation',)
isolation~meant	('meant~isolation',)
isolation~meant~not	('not~meant~isolation',)
isolation~meant~measures~not	('measures~not~meant~isolation',)
substitute	('substitute',)
isolation~substitute	('isolation~substitute',)
isolation~meant~substitute	('meant~isolation~substitute',)
isolation~meant~not~substitute	('not~meant~isolation~substitute',)
companys~substitute	('substitute~companys',)
companys~isolation~substitute	('isolation~substitute~companys',)
companys~isolation~meant~substitute	('meant~isolation~substitute~companys',)
companys~financial	('companys~financial',)
companys~financial~substitute	('substitute~companys~financial',)
companys~financial~isolation~substitute	('isolation~substitute~companys~financial',)
companys~financial~results	('companys~financial~results',)
companys~financial~results~substitute	('substitute~companys~financial~results',)
prepared	('prepared',)
prepared~results	('results~prepared',)
financial~prepared~results	('financial~results~prepared',)
companys~financial~prepared~results	('companys~financial~results~prepared',)
accordance	('accordance',)
accordance~prepared	('prepared~accordance',)
accordance~prepared~results	('results~prepared~accordance',)
accordance~financial~prepared~results	('financial~results~prepared~accordance',)
accordance~gaap	('accordance~gaap',)
accordance~gaap~prepared	('prepared~accordance~gaap',)
accordance~gaap~prepared~results	('results~prepared~accordance~gaap',)
companys~gaap	('gaap~companys',)
accordance~companys~gaap	('accordance~gaap~companys',)
accordance~companys~gaap~prepared	('prepared~accordance~gaap~companys',)
companys~gaap~non-gaap	('gaap~companys~non-gaap',)
accordance~companys~gaap~non-gaap	('accordance~gaap~companys~non-gaap',)
companys~measures~non-gaap	('companys~non-gaap~measures',)
companys~gaap~measures~non-gaap	('gaap~companys~non-gaap~measures',)
may~measures	('measures~may',)
may~measures~non-gaap	('non-gaap~measures~may',)
companys~may~measures~non-gaap	('companys~non-gaap~measures~may',)
different	('different',)
different~may	('may~different',)
different~may~measures	('measures~may~different',)
different~may~measures~non-gaap	('non-gaap~measures~may~different', 'measures~may~different~non-gaap', 'may~different~non-gaap~measures')
different~non-gaap	('different~non-gaap',)
different~may~non-gaap	('may~different~non-gaap',)
different~measures~non-gaap	('different~non-gaap~measures',)
measures~other	('measures~other', 'other~measures')
measures~non-gaap~other	('non-gaap~measures~other',)
different~measures~non-gaap~other	('different~non-gaap~measures~other',)
companies	('companies',)
companies~other	('other~companies',)
companies~measures~other	('measures~other~companies',)
companies~measures~non-gaap~other	('non-gaap~measures~other~companies',)
further	('further',)
further~information	('further~information', 'information~further')
further~information~information	('information~further~information',)
further~further~information~information	('further~information~further~information',)
relevant	('relevant',)
information~relevant	('information~relevant', 'relevant~information')
further~information~relevant	('further~information~relevant',)
further~information~relevant~relevant	('relevant~further~information~relevant',)
interpretation	('interpretation',)
interpretation~relevant	('relevant~interpretation',)
information~interpretation~relevant	('information~relevant~interpretation',)
further~information~interpretation~relevant	('further~information~relevant~interpretation',)
interpretation~non-gaap	('interpretation~non-gaap',)
interpretation~non-gaap~relevant	('relevant~interpretation~non-gaap',)
information~interpretation~non-gaap~relevant	('information~relevant~interpretation~non-gaap',)
financial~interpretation~non-gaap	('interpretation~non-gaap~financial',)
financial~interpretation~non-gaap~relevant	('relevant~interpretation~non-gaap~financial',)
financial~interpretation~measures~non-gaap	('interpretation~non-gaap~financial~measures',)
reconciliations	('reconciliations',)
measures~reconciliations	('measures~reconciliations',)
financial~measures~reconciliations	('financial~measures~reconciliations',)
financial~measures~non-gaap~reconciliations	('non-gaap~financial~measures~reconciliations', 'financial~measures~reconciliations~non-gaap', 'measures~reconciliations~non-gaap~financial', 'reconciliations~non-gaap~financial~measures')
non-gaap~reconciliations	('reconciliations~non-gaap',)
measures~non-gaap~reconciliations	('measures~reconciliations~non-gaap',)
financial~non-gaap~reconciliations	('reconciliations~non-gaap~financial',)
measures~most	('measures~most',)
financial~measures~most	('financial~measures~most',)
financial~measures~most~non-gaap	('non-gaap~financial~measures~most',)
comparable	('comparable',)
comparable~most	('most~comparable',)
comparable~measures~most	('measures~most~comparable',)
comparable~financial~measures~most	('financial~measures~most~comparable',)
comparable~gaap	('comparable~gaap',)
comparable~gaap~most	('most~comparable~gaap',)
comparable~gaap~measures~most	('measures~most~comparable~gaap', 'most~comparable~gaap~measures')
gaap~measures	('gaap~measures', 'measures~gaap')
comparable~gaap~measures	('comparable~gaap~measures',)
gaap~may~measures	('gaap~measures~may',)
comparable~gaap~may~measures	('comparable~gaap~measures~may',)
found	('found',)
found~may	('may~found',)
found~may~measures	('measures~may~found',)
found~gaap~may~measures	('gaap~measures~may~found',)
slide	('slide',)
found~slide	('found~slide',)
found~may~slide	('may~found~slide',)
found~may~measures~slide	('measures~may~found~slide',)
titled	('titled',)
slide~titled	('slide~titled',)
found~slide~titled	('found~slide~titled',)
found~may~slide~titled	('may~found~slide~titled',)
reconciliation	('reconciliation',)
reconciliation~titled	('titled~reconciliation',)
reconciliation~slide~titled	('slide~titled~reconciliation',)
found~reconciliation~slide~titled	('found~slide~titled~reconciliation',)
non-gaap~reconciliation	('reconciliation~non-gaap',)
non-gaap~reconciliation~titled	('titled~reconciliation~non-gaap',)
non-gaap~reconciliation~slide~titled	('slide~titled~reconciliation~non-gaap',)
gaap~non-gaap	('non-gaap~gaap', 'gaap~non-gaap')
gaap~non-gaap~reconciliation	('reconciliation~non-gaap~gaap',)
gaap~non-gaap~reconciliation~titled	('titled~reconciliation~non-gaap~gaap',)
financial~gaap	('gaap~financial',)
financial~gaap~non-gaap	('non-gaap~gaap~financial', 'gaap~non-gaap~financial')
financial~gaap~non-gaap~reconciliation	('reconciliation~non-gaap~gaap~financial',)
financial~gaap~measures	('gaap~financial~measures', 'financial~measures~gaap')
financial~gaap~measures~non-gaap	('non-gaap~gaap~financial~measures', 'non-gaap~financial~measures~gaap', 'gaap~non-gaap~financial~measures')
content	('content',)
