100s	100
10s	10
3ds	3d
\xa0as	\xa0a
abilities	ability
abs	ab
abstaining	abstain
academies	academy
accelerate	accelerated
accelerates	accelerated
accelerating	accelerated
acceleration	accelerated
accelerator	accelerated
accept	accepted
acceptability	accepted
acceptable	accepted
acceptance	accepted
accessed	access
accessible	access
accessing	access
accompanied	accompanying
accompany	accompanying
according	accordance
account	accounting
accountability	accounting
accountant	accounting
accountants	accounting
accounted	accounting
accounts	accounting
accrual	accruals
accrue	accrued
accruing	accrued
accurate	accurately
achieve	achievement
achieved	achievement
achievements	achievement
achieves	achievement
achieving	achievement
acquire	acquired
acquirer	acquired
acquires	acquired
acquiring	acquired
acquisitions	acquisition
acs	ac
acting	act
action	actions
active	activities
activity	activities
acts	act
actually	actual
adapt	adaptation
adapter	adaptation
adapters	adaptation
adaption	adaptation
adas	ada
adding	added
addition	additional
additionally	additional
additions	additional
addressed	address
addresses	address
addressing	address
adds	add
adequately	adequate
adheres	adhering
adjust	adjustments
adjusted	adjustments
adjusting	adjustments
adjustment	adjustments
administer	administering
administered	administering
administers	administering
administration	administrator
administrative	administrator
administratively	administrator
adopt	adopted
adopting	adopted
adoption	adopted
adopts	adopted
advanced	advance
advancement	advance
advances	advance
advancing	advance
advantage	advantages
adversely	adverse
advisable	advised
advise	advised
adviser	advised
advisers	advised
advises	advised
advising	advised
advisor	advisors
affected	affect
affecting	affect
affects	affect
affiliated	affiliate
affiliates	affiliate
affiliations	affiliate
afford	affords
agency	agencies
agendas	agenda
agents	agent
ages	age
aggregated	aggregate
agreements	agreement
aimed	aim
ais	ai
aligned	align
aligning	align
alignment	align
aligns	align
alleging	alleged
alliances	alliance
allocable	allocated
allocate	allocated
allocates	allocated
allocating	allocated
allocation	allocated
allow	allowance
allowances	allowance
allowed	allowance
allowing	allowance
allows	allowance
altered	alter
alternatively	alternative
alternatives	alternative
amend	amended
amendment	amended
amendments	amended
americas	america
amortize	amortization
amortized	amortization
amounts	amount
amplified	amplify
amplifiers	amplify
amplifying	amplify
analyzed	analyze
announce	announced
announcement	announced
announcements	announced
annualized	annual
annually	annual
anonymously	anonymous
answered	answer
answering	answer
answers	answer
anticipate	anticipated
anticipates	anticipated
anticipating	anticipated
anticipation	anticipated
appeals	appeal
appear	appearing
appearance	appearing
appears	appearing
application	applicable
applications	applicable
applied	apply
applies	apply
applying	apply
appoint	appointment
appointed	appointment
appoints	appointment
approaches	approach
appropriately	appropriate
appropriateness	appropriate
approvals	approval
approve	approval
approved	approval
approves	approval
approving	approval
approximate	approximately
approximates	approximately
approximating	approximately
architect	architects
architectural	architecture
architectures	architecture
area	areas
arise	arising
arises	arising
arrangement	arrangements
arrival	arrived
arts	art
ask	asking
aspects	aspect
assemble	assembly
assembled	assembly
assert	asserted
asserting	asserted
asserts	asserted
assess	assessment
assessed	assessment
assesses	assessment
assessing	assessment
assessments	assessment
asset	assets
assign	assigned
assigning	assigned
assignment	assigned
assignments	assigned
assistance	assist
assistant	assist
assistants	assist
assisting	assist
assists	assist
associate	associates
association	associates
associations	associates
assume	assumed
assumes	assumed
assuming	assumed
assumption	assumptions
assurances	assurance
atmospheric	atmosphere
attack	attacks
attainable	attainment
attained	attainment
attendance	attend
attended	attend
attending	attend
attest	attestation
attested	attestation
attorneys	attorney
attorneys-in-fact	attorneys-in-facts
attracted	attract
attracting	attract
attractive	attract
attracts	attract
attributed	attributable
attributes	attributable
attribution	attributable
audited	audit
auditing	audit
auditors	auditor
audits	audit
augment	augmented
authorities	authorized
authority	authorized
authorization	authorized
authorizations	authorized
authorizes	authorized
authorizing	authorized
automate	automation
automated	automation
automates	automation
automatically	automatic
automating	automation
automobile	automobiles
availability	available
avatars	avatar
averaging	average
award	awards
awarded	awards
awareness	aware
backgrounds	background
balanced	balance
balances	balance
balancing	balance
banks	bank
base	based
bases	based
becomes	become
becoming	become
begin	beginning
behaviors	behavior
belief	beliefs
believed	believe
believes	believe
beneficially	beneficial
beneficiaries	beneficiary
benefit	benefits
benefited	benefits
benefiting	benefits
billing	billed
billions	billion
bills	billed
biological	biology
block	blocks
blocked	blocks
blogs	blog
blurring	blurred
boards	board
bodies	body
books	book
boost	boosts
boosting	boosts
borrow	borrowing
boycotts	boycott
branding	brand
brands	brand
breaches	breach
bring	brings
bringing	brings
brokers	broker
budgets	budgeted
building	build
buildings	build
builds	build
businesses	business
bylaw	bylaws
cable	cables
calculating	calculated
calculation	calculated
californias	california
call	calls
called	calls
cancel	cancellation
canceled	cancellation
canceling	cancellation
cancellable	cancellation
cancelled	cancellation
capability	capabilities
capable	capabilities
capacities	capacity
capitalization	capital
capitalizations	capital
capitalize	capital
capitalized	capital
capped	cap
caps	cap
captioned	caption
captions	caption
captured	capture
cards	card
careers	career
carefully	care
carried	carrying
carry	carrying
carryforward	carryforwards
cars	car
case	cases
casting	cast
categories	category
caused	cause
causes	cause
causing	cause
ccs	cc
ceased	cease
ceases	cease
cells	cell
centers	center
central	centralized
ceos	ceo
certificates	certificate
certification	certificate
certifications	certificate
certifies	certified
certify	certified
chains	chain
chairpersons	chairperson
chairs	chair
challenge	challenges
challenging	challenges
chang	change
changed	change
changes	change
changing	change
changs	change
channels	channel
charged	charge
charges	charge
charters	charter
chatbot	chatbots
chemicals	chemical
chinas	china
chip	chips
chiplet	chiplets
choices	choice
choosing	choose
circuits	circuit
city	cities
claim	claims
claimed	claims
classes	class
classified	classify
closed	close
closely	close
closing	close
closures	closure
clouds	cloud
co-trustee	co-trustees
coding	code
collaborate	collaborations
collaborating	collaborations
collaboration	collaborations
collaborative	collaborations
collect	collected
collectability	collected
collecting	collected
collection	collected
collections	collected
collectively	collected
columns	column
combinations	combination
combine	combination
combined	combination
combines	combination
combining	combination
come	coming
comes	coming
commence	commencement
commenced	commencement
commencing	commencement
commerces	commerce
commercially	commercial
commitment	commitments
committed	commitments
committees	committee
communicate	community
communicated	community
communicates	community
communicating	community
communication	community
communications	community
communities	community
companies	company
companys	company
comparable	compared
comparably	compared
compare	compared
compares	compared
comparing	compared
comparisons	comparison
compensate	compensation
compensated	compensation
competencies	compete
competing	compete
competition	competitive
competitiveness	competitive
competitor	competitors
complaints	complaint
completed	complete
completely	complete
completeness	complete
completing	complete
completion	complete
complexity	complex
complied	comply
complies	comply
complying	comply
component	components
compose	composed
composite	composition
comprise	comprised
comprises	comprised
comprising	comprised
computation	computing
computational	computing
computationally	computing
computations	computing
compute	computing
computed	computing
computer	computing
computers	computing
concentrated	concentration
concentrations	concentration
concern	concerns
concerning	concerns
conclude	concluded
concludes	concluded
concluding	concluded
conclusions	conclusion
conclusive	conclusion
conclusively	conclusion
concurrent	concurrently
condition	conditions
conditioned	conditions
conducted	conduct
conducting	conduct
conducts	conduct
confer	conference
conferences	conference
confers	conference
confidentiality	confidential
confidentially	confidential
configurations	configuration
configurators	configuration
configured	configuration
configuring	configuration
confirm	confirming
conflict	conflicts
conflicting	conflicts
conform	conformity
connect	connection
connected	connection
connecting	connection
connections	connection
connectivity	connection
connects	connection
consents	consent
considerable	consideration
considerations	consideration
considering	consider
considers	consider
consist	consistent
consisted	consistent
consistency	consistent
consistently	consistent
consisting	consistent
consists	consistent
console	consoles
consolidation	consolidated
consolidations	consolidated
constitute	constituting
constitutes	constituting
constructing	construction
constructions	construction
constructively	construction
construed	construe
consult	consultant
consultants	consultant
consultation	consultant
consulting	consultant
consults	consultant
consumed	consumer
consumers	consumer
consuming	consumer
consummate	consummation
consummated	consummation
contacted	contact
contain	contained
containing	contained
containment	contained
contains	contained
contents	content
contests	contested
contingencies	contingent
contingency	contingent
continually	continued
continuation	continued
continue	continued
continues	continued
continuing	continued
continuity	continued
continuous	continued
continuously	continued
contract	contracts
contracted	contracts
contractor	contractors
contribute	contributions
contributed	contributions
contributes	contributions
contributing	contributions
contribution	contributions
controls	control
controversial	controversy
controversies	controversy
conventional	conventions
conversely	conversational
conversion	conversational
convertible	converted
coordination	coordinating
copies	copy
cores	core
corporation	corporate
corporations	corporate
correction	correct
corrections	correct
corrective	correct
correspond	corresponding
cost	costs
cost-effective	cost-effectively
count	counted
counterparts	counterpart
country	countries
covenant	covenants
cover	covered
covering	covered
covers	covered
covid-19s	covid-19
cpus	cpu
crafted	craft
created	create
creates	create
creating	create
credited	credit
credits	credit
cryptocurrencies	cryptocurrency
csp	csps
cultural	culture
currencies	currency
currently	current
custom	customers
customer	customers
customization	customers
customize	customers
customized	customers
customizing	customers
cycles	cycle
damaged	damage
damages	damage
database	databases
dated	date
dates	date
dawning	dawn
days	day
deadlines	deadline
deal	dealing
dealings	dealing
decade	decades
deceptive	deception
decided	decide
deciding	decide
decision	decisions
declaration	declared
declined	decline
declines	decline
decreased	decrease
decreases	decrease
dedicate	dedicated
deduct	deduction
deductibility	deduction
deductible	deduction
deductibles	deduction
deducting	deduction
deductions	deduction
deem	deemed
deems	deemed
defect	defects
defend	defending
defendants	defending
defer	deferred
deferral	deferrals
deficient	deficiencies
define	defined
definitions	definition
definitive	definition
degrees	degree
delay	delays
delayed	delays
delegate	delegated
delegates	delegated
delegation	delegated
delivered	deliver
deliveries	delivery
delivering	deliver
delivers	deliver
demanding	demand
demands	demand
demographic	demographics
demonstrate	demonstrated
demonstrations	demonstrated
denies	denied
denominator	denominated
departments	department
depend	depends
dependency	depends
dependent	depends
depending	depends
deployed	deploy
deploying	deploy
deployment	deploy
deposit	deposits
depreciated	depreciation
derivatives	derivative
derive	derivative
derived	derivative
describe	described
describes	described
designate	design
designated	design
designation	design
designed	design
designer	design
designers	design
designing	design
designs	design
desirable	desire
desired	desire
desires	desire
desktops	desktop
detail	details
detailed	details
detected	detect
detection	detect
determinable	determined
determination	determined
determinations	determined
determine	determined
determines	determined
determining	determined
develop	development
developed	development
developer	development
developers	development
developing	development
developments	development
device	devices
differ	different
difference	different
differences	different
differential	differentiated
differing	different
differs	different
difficulty	difficulties
digitalization	digital
digitalize	digital
digitally	digital
dilution	diluted
dilutive	diluted
directed	direct
direction	direct
directions	direct
directive	direct
director	directors
disabled	disability
disaster	disasters
disclosed	disclose
disclosing	disclose
disclosures	disclosure
discounted	discount
discover	discovered
discrete	discretion
discuss	discussion
discussed	discussion
discusses	discussion
discussing	discussion
discussions	discussion
disgorgement	disgorge
dismiss	dismissal
disposed	dispose
disposes	dispose
dispositions	disposition
dispositive	disposition
disproportionate	disproportionately
disqualify	disqualifying
disrupt	disruptions
disrupted	disruptions
disruption	disruptions
disruptive	disruptions
distribute	distribution
distributed	distribution
distributing	distribution
distributions	distribution
diverse	diversity
diversion	diversity
divestiture	divestitures
divide	divided
dividend	dividends
divisions	division
documenting	document
documents	document
doing	do
dollars	dollar
domain	domains
domestically	domestic
domestication	domestic
dpus	dpu
driver	drivers
drives	drive
driving	drive
drugs	drug
duty	duties
dynamic	dynamics
earn	earned
earnings	earned
earth-2s	earth-2
earths	earth
economics	economic
ecosystems	ecosystem
educate	education
educating	education
educational	education
educator	education
effect	effective
effected	effective
effecting	effective
effectively	effective
effectiveness	effective
effects	effective
efficiency	efficient
efficiently	efficient
effort	efforts
elapses	elapsed
elect	election
elected	election
electing	election
elections	election
electric	electricity
electrical	electricity
electronic	electronically
electronics	electronically
elects	election
element	elements
eligibility	eligible
eliminated	eliminate
embedding	embedded
emerge	emerging
emerged	emerging
emergence	emerging
emphasized	emphasize
employ	employment
employed	employment
employee	employees
employer	employment
enabled	enable
enabler	enable
enables	enable
enabling	enable
enactment	enacted
encountered	encounter
encourages	encourage
ended	end
ending	end
ends	end
energy-efficiency	energy-efficient
enforce	enforcement
enforceable	enforcement
enforced	enforcement
engage	engaged
engagement	engaged
engages	engaged
engaging	engaged
engine	engineering
engineer	engineering
engineers	engineering
enhanced	enhance
enhancement	enhance
enhancements	enhance
enhances	enhance
enrich	enrichment
entered	enter
enterprises	enterprise
enters	enter
entirely	entire
entity	entities
entitys	entities
environmentally	environmental
environments	environment
equaled	equal
equality	equal
equally	equal
equipped	equipment
equivalent	equivalents
eras	era
errors	error
essentially	essential
establish	established
establishes	established
establishing	established
estimate	estimated
estimates	estimated
estimating	estimated
ethics	ethical
ethnic	ethnicity
ethnically	ethnicity
ethnicities	ethnicity
evaluate	evaluating
evaluated	evaluating
evaluates	evaluating
evaluation	evaluating
evaluations	evaluating
events	event
evidenced	evidencing
evolve	evolving
evolved	evolving
exacerbate	exacerbated
examining	examination
examples	example
exceeded	exceed
exceeding	exceed
excel	excellence
excellent	excellence
exception	except
exceptional	except
exceptions	except
excessive	excess
exchanged	exchange
exchanges	exchange
excited	exciting
excluded	exclude
excludes	exclude
excluding	exclude
exclusion	exclusions
exclusive	exclusions
exclusively	exclusions
execute	executive
executed	executive
execution	executive
executives	executive
exemption	exempt
exemptions	exempt
exequitys	exequity
exercisability	exercise
exercisable	exercise
exercised	exercise
exercises	exercise
exercising	exercise
exhibits	exhibit
exist	existing
exists	existing
exited	exit
expand	expanding
expanded	expanding
expands	expanding
expect	expected
expectation	expected
expectations	expected
expects	expected
expenditure	expenditures
expensed	expense
expenses	expense
expensive	expense
experiences	experience
experts	expert
expire	expiration
expired	expiration
expires	expiration
expiring	expiration
explore	exploration
explored	exploration
exporting	export
exports	export
expose	exposed
exposes	exposed
exposures	exposure
express	expressed
expression	expressed
expressions	expressed
extend	extended
extending	extended
extends	extended
extensive	extension
extremely	extreme
fabric	fabrication
faced	face
facilitates	facilitate
facilitating	facilitate
facility	facilities
facing	face
fact	facts
factor	factors
factory	factories
failed	fail
failing	fail
fails	fail
failures	failure
fairness	fair
familiarity	familiar
families	family
favor	favorable
feasible	feasibility
feature	features
featured	features
featuring	features
fee	fees
fields	field
file	filed
files	filed
filing	filed
filings	filed
filled	fill
finality	final
finalization	final
finalized	final
finally	final
finances	finance
financials	financial
financing	finance
firms	firm
fix	fixed
fixing	fixed
fleets	fleet
flexible	flexibility
flows	flow
fluctuate	fluctuations
fluctuated	fluctuations
focuses	focused
follow	following
followed	following
follows	following
forces	force
forecasted	forecast
forecasting	forecast
forecasts	forecast
forfeiture	forfeitures
formed	form
forming	form
forms	form
fortune	fortunes
forums	forum
forwarded	forward
forwarding	forward
foster	fostering
foundational	foundation
foundations	foundation
founded	found
founders	founder
founding	found
foundry	foundries
foundrys	foundries
frame	frames
frameworks	framework
frontiers	frontier
fuel	fueled
fueling	fueled
fulfilling	fulfill
fulfillment	fulfill
function	functions
functional	functions
functionalities	functions
functionality	functions
functionally	functions
functioning	functions
fund	funds
fundamentally	fundamental
furnish	furnished
gain	gains
gained	gains
gainful	gains
game	gaming
gamer	gamers
games	gaming
gamings	gaming
gdprs	gdpr
generally	general
generate	general
generated	general
generates	general
generating	general
generation	general
generational	general
generations	general
generative	general
geographical	geographic
gigabyte	gigabytes
gives	give
giving	give
globally	global
goal	goals
going	go
good	goods
govern	governance
governing	governance
government	governance
governments	governance
gpu	gpus
grant	granted
granting	granted
grants	granted
graphs	graph
groups	group
grow	growing
grows	growing
guaranteed	guarantee
guarantees	guarantee
guide	guided
guiding	guided
hand	hands
happened	happening
harmed	harm
harming	harm
harms	harm
harnesses	harness
having	have
headquarter	headquarters
headquartered	headquarters
heads	heading
hedged	hedge
hedges	hedge
hedging	hedge
helped	help
helping	help
helps	help
hire	hiring
hired	hiring
hires	hiring
historically	historical
histories	history
hold	holds
holder	holders
holding	holds
holdings	holds
holiday	holidays
hosted	host
householding	household
https	http
huangs	huang
humanitys	human
humans	human
hundred	hundreds
hyperscaler	hyperscale
identical	identity
identifies	identified
identify	identified
identifying	identified
image	images
imagine	imagination
imaging	images
immediate	immediately
immensely	immense
impacted	impact
impactful	impact
impacting	impact
impacts	impact
impair	impairment
impaired	impairment
impairing	impairment
impairments	impairment
implementation	implement
implemented	implement
implementing	implement
implements	implement
import	important
importance	important
imports	important
imposed	impose
imposes	impose
improve	improvements
improved	improvements
improvement	improvements
improves	improvements
improving	improvements
inactions	inactive
incentives	incentive
incidence	incident
include	including
includes	including
includible	including
inclusions	inclusion
inclusive	inclusion
incoming	income
inconsistency	inconsistent
incorporate	incorporated
incorporates	incorporated
incorporating	incorporated
incorporation	incorporated
increased	increase
increases	increase
increasing	increase
incredibly	incredible
incurred	incur
incurring	incur
indefinite	indefinitely
indemnifications	indemnification
indemnitee	indemnitees
indemnities	indemnity
independence	independent
independently	independent
indicated	indicate
indicates	indicate
indication	indicate
indicative	indicate
indicators	indicate
indices	indicate
individuals	individual
industrial	industry
industries	industry
industrys	industry
informational	information
informed	information
informs	information
infringe	infringement
inherent	inherently
initial	initially
initiate	initially
initiated	initially
initiative	initially
initiatives	initially
injunction	injunctive
injury	injurious
innovated	innovation
innovations	innovation
innovators	innovation
inputs	input
inquiry	inquiries
inside	insider
insights	insight
inspection	inspections
installments	installed
instance	instances
instituted	institute
institution	institute
institutional	institute
institutions	institute
instruction	instructions
instrument	instruments
instrumental	instruments
instrumentation	instruments
insurers	insurance
intangibles	intangible
integral	integrated
integrate	integrated
integrating	integrated
integration	integrated
integrations	integrated
integrity	integrated
intelligent	intelligence
intend	intended
intends	intended
intense	intensive
intensely	intensive
intentionally	intention
intents	intention
interactions	interactive
interacts	interactive
interconnects	interconnect
interests	interest
intermediary	intermediaries
internally	internal
international	internal
internationally	internal
interpret	interpretation
interpretations	interpretation
interpreted	interpretation
interrupted	interruption
interview	interviews
introduce	introduced
introduces	introduced
introduction	introductions
invented	invents
inventing	invents
invention	invents
inventions	invents
inventories	inventory
invest	investment
invested	investment
investigations	investigation
investigator	investigation
investing	investment
investments	investment
investors	investor
invoicing	invoiced
involve	involving
involved	involving
involvement	involving
involves	involving
islander	islands
isos	iso
issuances	issuance
issue	issued
issuers	issuer
issues	issued
issuing	issued
items	item
jds	jd
job	jobs
joining	joined
judgments	judgment
jurisdiction	jurisdictions
jurisdictional	jurisdictions
keys	key
kit	kits
knowledgeable	knowledge
knows	know
l40	l40s
labs	lab
lacking	lack
languages	language
laptop	laptops
largely	large
lasted	last
launch	launched
law	laws
lawful	laws
lawfully	laws
lawsuit	lawsuits
layers	layer
lead-time	lead-times
leader	leaders
leading	lead
leads	lead
leap	leaps
leaped	leaps
learn	learning
learned	learning
learns	learning
leased	lease
leases	lease
legally	legal
legislative	legislation
let	lets
letters	letter
levels	level
leverage	leveraging
leveraged	leveraging
leverages	leveraging
liability	liabilities
library	libraries
licensed	license
licenses	license
licensing	license
lifecycles	lifecycle
lifes	life
like	likely
lillys	lilly
limit	limited
limitation	limited
limitations	limited
limiting	limited
limits	limited
link	linking
links	linking
liquid	liquidity
liquidating	liquidity
liquidation	liquidity
listed	list
listing	list
lists	list
litigating	litigation
live	lives
living	lives
llms	llm
llps	llp
localities	local
localization	local
locate	location
locations	location
lockdown	lockdowns
logistical	logistics
look	looking
looks	looking
losses	loss
lowes	low
lsis	lsi
machines	machine
mailing	mail
maintained	maintain
maintaining	maintain
maintains	maintain
major	majority
maker	makers
makes	make
making	make
manage	management
managed	management
managements	management
manager	management
managers	management
manages	management
managing	management
manufacture	manufacturing
manufactured	manufacturing
manufacturer	manufacturing
manufacturers	manufacturing
map	mapping
marginal	margin
margins	margin
marked	mark
marketable	market
marketed	market
marketers	market
marketing	market
markets	market
marking	mark
marvels	marvell
massively	massive
matches	match
materialize	material
materializing	material
materially	material
materials	material
matter	matters
mature	maturity
matures	maturity
maturities	maturity
mean	means
meaning	means
meaningfully	meaningful
measure	measures
measured	measures
measurement	measures
measuring	measures
mechanics	mechanical
mechanism	mechanical
mechanisms	mechanical
mediateks	mediatek
medically	medical
medicine	medicines
meet	meeting
meetings	meeting
meets	meeting
mellanoxs	mellanox
member	members
memberships	membership
mercedes-benzs	mercedes-benz
mergers	merger
merit	merits
methods	method
metric	metrics
microsofts	microsoft
millions	million
minds	mind
mine	mining
minerals	miners
minimal	minimize
misappropriated	misappropriation
mismatches	mismatch
misstatements	misstatement
mitigate	mitigation
mitigates	mitigation
mitigating	mitigation
mobility	mobile
model	models
modeling	models
moderate	moderating
modernizing	modern
modifications	modification
modified	modify
monitor	monitors
monitoring	monitors
month	months
moore	moores
motivating	motivate
motivation	motivate
move	moves
movies	movie
mtgs	mtg
multi-node	multi-nodes
multiples	multiple
multiplied	multiplying
multiplier	multiplying
named	name
names	name
nasdaqs	nasdaq
nationals	national
nations	national
natural	nature
neals	neal
needed	need
needing	need
needs	need
negative	negatively
neo	neos
network	networking
networks	networking
node	nodes
nominal	nominations
nominate	nominations
nominated	nominations
nominating	nominations
nomination	nominations
nominees	nominee
non-affiliates	non-affiliated
non-cancelable	non-cancellable
non-compliant	non-compliance
non-operational	non-operating
non-profits	non-profit
non-vote	non-votes
nos	no
note	notes
notebook	notebooks
noted	notes
notify	notified
nso	nsos
numbers	number
numerator	numerous
numerical	numerous
nvidias	nvidia
objective	objectives
objectively	objectives
objectivity	objectives
objects	objectives
obligate	obligations
obligation	obligations
observed	observable
obtained	obtain
obtaining	obtain
occurred	occur
occurring	occur
occurs	occur
oem	oems
offered	offer
offering	offer
offerings	offer
offers	offer
office	officer
officers	officer
offices	officer
offs	off
offsets	offset
offsetting	offset
opened	open
opening	open
opens	open
operate	operating
operated	operating
operates	operating
operation	operating
operational	operating
operations	operating
operative	operating
opinions	opinion
opportunities	opportunity
optimization	optimized
optimizations	optimized
optimize	optimized
optimizing	optimized
options	option
ordering	order
orders	order
organization	organizations
organized	organizations
originally	original
others	other
outcomes	outcome
overestimation	overestimate
oversee	oversees
overseeing	oversees
owed	owe
owned	own
owner	owners
owning	own
owns	own
package	packaging
packaged	packaging
pandemics	pandemic
papering	paper
parameters	parameter
parents	parent
partial	partially
participants	participant
participate	participant
participated	participant
participation	participant
partner	partners
partnered	partners
partnering	partners
partnerships	partnership
party	parties
partys	parties
patent	patents
paths	path
pattern	patterns
paying	pay
payments	payment
payouts	payout
pcs	pc
peers	peer
penalty	penalties
perceive	perceived
percentages	percentage
percentiles	percentile
perceptions	perception
perform	performance
performed	performance
performing	performance
periodic	period
periodically	period
periods	period
permanently	permanent
permit	permitted
permits	permitted
person	personal
persons	personal
perspective	perspectives
pertain	pertaining
phase	phases
philosophies	philosophy
phones	phone
physically	physical
physics	physical
pipelines	pipeline
pixars	pixar
placed	place
places	place
placing	place
planned	plan
planner	planners
planning	plan
plans	plan
plant	plants
platforms	platform
playing	play
pledging	pledge
point	points
policy	policies
politics	political
popular	popularity
portfolios	portfolio
portions	portion
posed	poses
positioned	position
positioning	position
positions	position
positive	position
possess	possession
possessed	possession
possessing	possession
possibility	possible
post	posted
potentially	potential
powered	power
powerful	power
powering	power
powers	power
practicable	practices
practical	practices
practice	practices
pre-approvals	pre-approval
pre-approve	pre-approval
pre-approved	pre-approval
precisely	precision
predicting	predict
prediction	predict
predictions	predict
predictive	predict
prefer	preferred
preference	preferred
preferences	preferred
premium	premiums
prepaids	prepaid
prepare	preparation
prepared	preparation
prepares	preparation
preparing	preparation
prepay	prepayment
prepayments	prepayment
presentation	present
presentations	present
presented	present
presently	present
presents	present
presiding	president
preventative	prevent
prevented	prevent
preventing	prevent
prevention	prevent
prevents	prevent
priced	price
prices	price
pricing	price
principle	principles
print	printed
priorities	priority
prioritizing	prioritize
privately	private
problem	problems
procedural	procedures
proceed	proceedings
processed	process
processes	process
processing	process
processor	processors
procurement	procure
product	products
production	products
productivity	products
professionals	professional
professors	professor
profitability	profit
profitable	profit
profits	profit
programmability	programmable
programming	program
programs	program
progressive	progress
prohibit	prohibited
prohibitions	prohibited
projected	project
projections	project
projects	project
proliferation	proliferating
promise	promising
promoted	promote
promotes	promote
promoting	promote
promotion	promote
promotions	promote
prompted	prompts
pronounced	pronouncements
pronouncement	pronouncements
propelling	propel
properties	property
proportional	proportion
proportions	proportion
proposal	proposed
proposals	proposed
protect	protection
protecting	protection
protections	protection
proves	prove
providence	providing
provider	providing
providers	providing
provision	provisions
proxies	proxy
psu	psus
publication	public
publish	published
publisher	published
publishers	published
publishing	published
pull	pulled
purchased	purchase
purchaser	purchase
purchases	purchase
purchasing	purchase
purpose	purposes
pursuing	pursue
putative	put
puts	put
putting	put
pwcs	pwc
qualification	qualifications
qualified	qualify
qualifies	qualify
qualifying	qualify
quantity	quantities
quarters	quarter
question	questions
questionable	questions
races	race
racial	racially
racing	race
racks	rack
raised	raising
ramped	ramp
ramping	ramp
ranges	range
ranging	range
ranking	ranked
rapids	rapid
rated	rate
rates	rate
ratified	ratify
ratifying	ratify
rating	rate
ratings	rate
ratios	ratio
rbas	rba
reached	reach
reaches	reach
reaching	reach
ready	readiness
realizable	realized
realization	realized
realize	realized
realizing	realized
reason	reasonable
reasonableness	reasonable
reasonably	reasonable
reasons	reasonable
receipts	receipt
receivable	receive
receivables	receive
received	receive
receives	receive
receiving	receive
recent	recently
recipients	recipient
reclassifications	reclassification
reclassify	reclassified
recognize	recognized
recognizes	recognized
recognizing	recognized
recommend	recommendation
recommendations	recommendation
recommended	recommendation
recommender	recommendation
recommenders	recommendation
recommending	recommendation
recommends	recommendation
reconciliations	reconciliation
reconciling	reconcile
record	recorded
recording	recorded
records	recorded
recoup	recoupment
recoverability	recoverable
recruit	recruiting
recruitment	recruiting
recruits	recruiting
redeem	redeemed
reduced	reduce
reduces	reduce
reducing	reduce
reductions	reduction
refactor	refactoring
refer	reference
references	reference
referred	reference
refers	reference
refine	refinance
refinement	refinance
refining	refinance
reflected	reflect
reflecting	reflect
reflections	reflect
reflects	reflect
reforms	reform
refresh	refreshment
regard	regarding
regarded	regarding
region	regions
regional	regions
register	registered
registrants	registrant
registration	registrant
regulation	regulations
regulator	regulations
regulators	regulations
reimburse	reimbursement
reimbursed	reimbursement
reimbursements	reimbursement
reincorporation	reincorporated
reinforce	reinforced
reinvent	reinvented
reinventing	reinvented
reinvents	reinvented
reinvest	reinvested
reinvestment	reinvested
relate	related
relates	related
relating	related
relation	related
relations	related
relationship	relationships
relatively	relative
release	releases
released	releases
reliable	reliability
reliably	reliability
relies	rely
remained	remain
remaining	remain
remains	remain
remeasurement	remeasured
remedial	remediate
remediated	remediate
remediation	remediate
remedies	remediate
remedy	remediate
remote	remotely
removing	removed
render	rendering
rendered	rendering
renders	rendering
reopened	reopen
repatriate	repatriation
repatriating	repatriation
repay	repayment
repayments	repayment
repealed	repeal
replacement	replace
reportable	report
reported	report
reporter	report
reporters	report
reporting	report
reports	report
represent	represents
representation	representations
representative	represents
representatives	represents
represented	represents
representing	represents
repricing	reprice
repurchased	repurchase
repurchases	repurchase
reputational	reputation
request	requested
requesting	requested
requests	requested
require	required
requirement	required
requirements	required
requires	required
requiring	required
requisitions	requisite
resale	resales
researcher	research
researchers	research
reseller	resellers
reservation	reserve
reserved	reserve
reserves	reserve
reside	residence
residency	residence
residents	residence
resides	residence
resolutions	resolution
resolve	resolved
resource	resources
resourced	resources
respected	respect
respective	respect
respectively	respect
respects	respect
response	responsible
responses	responsible
responsibilities	responsible
responsibility	responsible
responsibly	responsible
responsive	responsible
restate	restated
restatement	restated
restatements	restated
restrict	restricted
restricting	restricted
restrictions	restricted
restricts	restricted
result	results
resulted	results
resulting	results
resumed	resume
retailer	retail
retailers	retail
retained	retain
retainer	retain
retaining	retain
retains	retain
retentive	retention
retired	retirement
returned	return
returning	return
returns	return
revenues	revenue
reviewed	review
reviewing	review
reviews	review
revise	revised
revisions	revised
revoking	revoke
revolutionized	revolutionize
revolutionizes	revolutionize
revolutionizing	revolutionize
reward	rewards
right	rights
rigs	rig
rising	rise
risk	risks
robot	robotics
robotaxi	robotaxis
robotic	robotics
robots	robotics
roles	role
rotated	rotations
rotates	rotations
rows	row
royalties	royalty
rsu	rsus
rule	rules
ruling	rules
rulings	rules
run	running
runs	running
safeguarding	safeguards
sale	sales
samples	sampling
sars	sar
satisfied	satisfy
satisfying	satisfy
save	savings
saved	savings
scalability	scalable
scaled	scale
scales	scale
scaling	scale
scenes	scene
scheduled	schedule
schedules	schedule
sciences	science
scientist	scientists
sdk	sdks
season	seasonality
seasonal	seasonality
seasoned	seasonality
secs	sec
sections	section
secure	securities
securely	securities
security	securities
seeking	seek
seeks	seek
segments	segment
select	selection
selected	selection
selections	selection
selects	selection
selling	sell
semiconductors	semiconductor
sending	send
sensitivity	sensitive
sensors	sensor
separately	separate
separation	separate
sequentially	sequential
serve	served
servers	server
serves	served
service	services
serving	served
session	sessions
sets	set
setting	set
settings	set
settle	settled
settlements	settlement
severance	several
severe	several
shaping	shape
share	shares
shared	shares
shareholder	shareholders
sharing	shares
sheets	sheet
shifting	shift
shifts	shift
shipment	shipments
shipped	ship
shipping	ship
shortage	shortages
shutting	shut
sign	signing
signatures	signature
signed	signing
significance	significant
simulate	simulation
simulates	simulation
simulating	simulation
simulations	simulation
sites	site
situations	situated
sizes	size
skill	skills
skilled	skills
slow	slowing
slowed	slowing
smartphones	smartphone
socially	social
socs	soc
solely	sole
solicited	solicit
soliciting	solicit
solicits	solicit
solution	solutions
sounds	sound
sources	source
sourcing	source
specialize	special
specialized	special
specific	specifically
specification	specifically
specifications	specifically
specify	specified
speed-up	speed-ups
speedup	speedups
splits	split
sponsors	sponsoring
spreading	spread
stack	stacks
stakeholder	stakeholders
standard	standards
standardization	standards
standardize	standards
start	starting
started	starting
starts	starting
startup	startups
state	states
stated	states
statement	statements
stating	states
statistically	statistics
stay	stayed
stephens	stephen
stockholder	stockholders
stopped	stopping
store	stored
stores	stored
storms	storm
strategies	strategy
stream	streaming
strengthen	strengthened
strengthening	strengthened
strengthens	strengthened
strives	strive
structural	structure
structured	structure
structures	structure
student	students
studios	studio
subcontractor	subcontractors
subjective	subject
subjectivity	subject
subjects	subject
submissions	submission
submits	submit
submitted	submit
submitting	submit
subscriptions	subscription
subsequently	subsequent
subside	subsidize
subsidiary	subsidiaries
substantially	substantial
substituted	substitute
substitutes	substitute
substitution	substitute
successful	success
successfully	success
succession	success
successors	successor
sufficiently	sufficient
suggest	suggestion
suited	suite
summarization	summarizes
summarize	summarizes
summarized	summarizes
summarizing	summarizes
superchip	superchips
supercomputers	supercomputer
supercomputing	supercomputer
superpods	superpod
supplements	supplemental
supplier	suppliers
supported	support
supporting	support
supportive	support
supports	support
survey	surveys
suspended	suspend
sustainable	sustainability
sustained	sustainability
switches	switch
system	systems
tables	table
taiwans	taiwan
takes	take
taking	take
talented	talent
targeted	target
targeting	target
targets	target
task	tasks
taxed	tax
taxes	tax
taxing	tax
teams	team
technique	techniques
technological	technology
technologies	technology
tendered	tender
tendering	tender
tenders	tender
tens	ten
tension	tensions
term	terms
terminate	termination
terminated	termination
terminates	termination
tested	test
testing	test
tests	test
teters	teter
thing	things
thought	thoughts
thoughtful	thoughts
thousand	thousands
threats	threat
thresholds	threshold
timeframes	timeframe
timely	time
times	time
timing	time
title	titled
titles	titled
todays	today
tool	tools
topic	topics
tops	top
totaled	total
totaling	total
toward	towards
traded	trade
trading	trade
traditionally	traditional
train	training
trained	training
transactional	transaction
transactions	transaction
transferability	transfer
transferable	transfer
transferred	transfer
transferring	transfer
transfers	transfer
transformation	transform
transformational	transform
transformative	transform
transformer	transform
transformers	transform
transforming	transform
transforms	transform
transitioned	transition
transitioning	transition
transitions	transition
translate	translation
translates	translation
translating	translation
treating	treated
trend	trends
trillions	trillion
truck	trucks
trucking	trucks
trustees	trustee
trustworthy	trustworthiness
tsrs	tsr
turning	turn
twins	twin
type	types
ultimately	ultimate
uncertainty	uncertainties
understand	understanding
understandings	understanding
understands	understanding
undertake	undertaking
unexercisable	unexercised
uniquely	unique
unit	united
units	united
universal	university
universe	university
universities	university
universitys	university
unlocking	unlock
unlocks	unlock
unreal	unrealized
updated	update
updates	update
updating	update
upgraded	upgrade
upgrades	upgrade
upholding	uphold
user	users
uses	useful
utility	utilize
utilization	utilize
utilized	utilize
utilizing	utilize
validate	valid
validated	valid
validating	valid
validity	valid
valued	value
values	value
valuing	value
variability	variable
vary	varied
varying	varied
vehicles	vehicle
venture	ventures
version	versions
vested	vest
vesting	vest
vests	vest
videos	video
viewed	view
views	view
violate	violations
violated	violations
violating	violations
violation	violations
virtually	virtual
visual	visualization
volatile	volatility
volumes	volume
voted	vote
votes	vote
voting	vote
vulnerability	vulnerabilities
vulnerable	vulnerabilities
wafers	wafer
warehouse	warehouses
warrant	warrants
warranted	warrants
warranties	warranty
waves	wave
ways	way
weaknesses	weakness
webcasts	webcast
websites	website
week	weeks
weight	weighted
weighting	weighted
wells	well
widely	wide
wildfires	wildfire
win	wins
wishes	wish
withhold	withholding
witness	witnessed
worked	work
workers	worker
working	work
workload	workloads
works	work
workstation	workstations
world	worlds
wpps	wpp
write	writing
write-downs	write-down
write-offs	write-off
writes	writing
years	year
yielding	yield
yields	yield
