investor	('investor', 'investors')
present	('presentation', 'present', 'presented', 'presentations', 'presents', 'presently')
q2	('q2',)
fy24	('fy24',)
august	('august',)
28	('28',)
2023	('2023',)
except	('except', 'exceptional', 'exception', 'exceptions')
histor	('historical', 'historically')
inform	('information', 'informs', 'informational', 'informed')
contain	('contained', 'contains', 'contain', 'containing', 'containment')
herein	('herein',)
certain	('certain',)
matter	('matters', 'matter')
includ	('including', 'include', 'includes', 'includible')
not	('not',)
limit	('limited', 'limitations', 'limit', 'limits', 'limitation', 'limiting')
statement	('statements', 'statement')
financi	('financial', 'financials')
posit	('position', 'positioned', 'positions', 'positive', 'positioning')
market	('markets', 'market', 'marketable', 'marketers', 'marketing', 'marketed')
opportun	('opportunity', 'opportunities')
demand	('demand', 'demands', 'demanding')
growth	('growth',)
driver	('drivers', 'driver')
csp	('csps', 'csp')
undertak	('undertaking', 'undertake')
gener	('generational', 'generative', 'generating', 'generation', 'generate', 'generates', 'general', 'generally', 'generations', 'generated')
transit	('transition', 'transitioned', 'transitioning', 'transitions')
updat	('update', 'updated', 'updates', 'updating')
infrastructur	('infrastructure',)
new	('new',)
era	('era', 'eras')
acceler	('accelerated', 'acceleration', 'accelerating', 'accelerate', 'accelerates', 'accelerator')
comput	('computing', 'compute', 'computers', 'computer', 'computation', 'computational', 'computationally', 'computed', 'computations')
ai	('ai', 'ais')
enterpris	('enterprises', 'enterprise')
race	('racing', 'race', 'races')
adopt	('adopt', 'adoption', 'adopted', 'adopts', 'adopting')
belief	('belief', 'beliefs')
global	('global', 'globally')
end	('end', 'ends', 'ended', 'ending')
game	('gaming', 'games', 'game', 'gamings')
ha	('has',)
return	('returned', 'returns', 'return', 'returning')
grow	('growing', 'grows', 'grow')
number	('number', 'numbers')
gpu	('gpu', 'gpus')
cloud	('cloud', 'clouds')
provid	('providers', 'providing', 'provider', 'providence')
deploy	('deploying', 'deploy', 'deployed', 'deployment')
volum	('volume', 'volumes')
hgx	('hgx',)
system	('systems', 'system')
base	('based', 'base', 'bases')
hopper	('hopper',)
amper	('ampere',)
architectur	('architecture', 'architectures', 'architectural')
expect	('expectation', 'expected', 'expectations', 'expect', 'expects')
data	('data',)
center	('center', 'centers')
suppli	('supply',)
increas	('increase', 'increased', 'increases', 'increasing')
each	('each',)
quarter	('quarter', 'quarters')
next	('next',)
year	('year', 'years')
larg	('large', 'largely')
upgrad	('upgrade', 'upgraded', 'upgrades')
ahead	('ahead',)
likelihood	('likelihood',)
season	('seasonality', 'season', 'seasoned', 'seasonal')
overal	('overall',)
shift	('shift', 'shifts', 'shifting')
rtx	('rtx',)
dlss	('dlss',)
ecosystem	('ecosystem', 'ecosystems')
continu	('continuing', 'continues', 'continued', 'continue', 'continuous', 'continuity', 'continuation', 'continuously', 'continually')
expand	('expand', 'expanding', 'expanded', 'expands')
time	('timing', 'time', 'times', 'timely')
desktop	('desktop', 'desktops')
workstat	('workstation', 'workstations')
refresh	('refresh', 'refreshment')
profession	('professional', 'professionals')
visual	('visualization', 'visual')
technolog	('technology', 'technologies', 'technological')
impact	('impact', 'impactful', 'impacts', 'impacted', 'impacting')
partnership	('partnership', 'partnerships')
mediatek	('mediatek', 'mediateks')
outlook	('outlook',)
sequenti	('sequential', 'sequentially')
driven	('driven',)
also	('also',)
contribut	('contributing', 'contributions', 'contribution', 'contribute', 'contributes', 'contributed')
tax	('tax', 'taxes', 'taxed', 'taxing')
rate	('rates', 'rate', 'rating', 'rated', 'ratings')
third	('third',)
fiscal	('fiscal',)
2024	('2024',)
benefit	('benefits', 'benefiting', 'benefit', 'benefited')
perform	('performance', 'perform', 'performing', 'performed')
featur	('features', 'featuring', 'feature', 'featured')
avail	('availability', 'available')
product	('products', 'production', 'product', 'productivity')
collabor	('collaborations', 'collaborating', 'collaborative', 'collaborate', 'collaboration')
nvidia	('nvidia', 'nvidias')
be	('being',)
broadli	('broadly',)
recogn	('recognized', 'recognizing', 'recognize', 'recognizes')
way	('way', 'ways')
advanc	('advance', 'advanced', 'advancing', 'advances', 'advancement')
moor	('moores', 'moore')
law	('law', 'laws', 'lawful', 'lawfully')
need	('needed', 'needs', 'need', 'needing')
tackl	('tackle',)
most	('most',)
valu	('value', 'valued', 'values', 'valuing')
everi	('every',)
stakehold	('stakeholder', 'stakeholders')
greatest	('greatest',)
forc	('force', 'forces')
unlock	('unlocking', 'unlock', 'unlocks')
industri	('industries', 'industrial', 'industry', 'industrys')
becom	('becoming', 'become', 'becomes')
factori	('factories', 'factory')
wave	('wave', 'waves')
robot	('robotics', 'robotic', 'robots', 'robot')
digit	('digitalization', 'digital', 'digitally', 'digitalize')
omnivers	('omniverse',)
essenti	('essential', 'essentially')
stack	('stacks', 'stack')
help	('helping', 'helps', 'help', 'helped')
bring	('bring', 'bringing', 'brings')
world	('worlds', 'world')
largest	('largest',)
expertis	('expertise',)
scale	('scale', 'scaling', 'scaled', 'scales')
revolution	('revolutionize', 'revolutionizing', 'revolutionized', 'revolutionizes')
busi	('businesses', 'business')
softwar	('software',)
servic	('services', 'service')
enabl	('enabling', 'enables', 'enable', 'enabler', 'enabled')
cost	('cost', 'costs')
time-to-solut	('time-to-solution',)
save	('savings', 'save', 'saved')
applic	('application', 'applications', 'applicable')
speed-up	('speed-ups', 'speed-up')
dividend	('dividend', 'dividends')
program	('program', 'programming', 'programs')
plan	('plan', 'planning', 'plans', 'planned')
automot	('automotive',)
design	('design', 'designed', 'designing', 'designers', 'designation', 'designated', 'designs', 'designate', 'designer')
win	('win', 'wins')
pipelin	('pipeline', 'pipelines')
ramp	('ramp', 'ramping', 'ramped')
aim	('aim', 'aimed')
engag	('engage', 'engagement', 'engaging', 'engaged', 'engages')
manufactur	('manufacturing', 'manufacture', 'manufacturers', 'manufacturer', 'manufactured')
supplier	('suppliers', 'supplier')
goal	('goal', 'goals')
effect	('effecting', 'effect', 'effective', 'effectively', 'effectiveness', 'effects', 'effected')
science-bas	('science-based',)
environment	('environmental', 'environmentally')
target	('targets', 'target', 'targeted', 'targeting')
2026	('2026',)
100%	('100%',)
renew	('renewable',)
electr	('electricity', 'electric', 'electrical')
oper	('operations', 'operating', 'operation', 'operational', 'operates', 'operate', 'operated', 'operative')
2025	('2025',)
annual	('annually', 'annual', 'annualized')
thereaft	('thereafter',)
forward-look	('forward-looking',)
other	('other', 'others')
go	('go', 'going')
beyond	('beyond',)
fact	('facts', 'fact')
made	('made',)
subject	('subject', 'subjects', 'subjective', 'subjectivity')
risk	('risks', 'risk')
uncertainti	('uncertainties', 'uncertainty')
may	('may',)
caus	('cause', 'causes', 'caused', 'causing')
actual	('actual', 'actually')
result	('results', 'resulting', 'result', 'resulted')
differ	('differ', 'different', 'difference', 'differing', 'differences', 'differs')
materi	('materially', 'material', 'materials', 'materialize', 'materializing')
import	('important', 'importance', 'import', 'imports')
factor	('factors', 'factor')
could	('could',)
econom	('economic', 'economics')
condit	('conditions', 'condition', 'conditioned')
relianc	('reliance',)
parti	('parties', 'party', 'partys')
assembl	('assemble', 'assembly', 'assembled')
packag	('package', 'packaging', 'packaged')
test	('test', 'testing', 'tested', 'tests')
develop	('development', 'develop', 'developers', 'developing', 'developed', 'developments', 'developer')
competit	('competition', 'competitive', 'competitiveness')
enhanc	('enhancements', 'enhances', 'enhanced', 'enhance', 'enhancement')
exist	('existing', 'exists', 'exist')
accept	('acceptance', 'accepted', 'accept', 'acceptability', 'acceptable')
partner	('partners', 'partnered', 'partner', 'partnering')
defect	('defects', 'defect')
chang	('changes', 'change', 'changed', 'chang', 'changs', 'changing')
consum	('consumer', 'consumers', 'consumed', 'consuming')
prefer	('preferences', 'preference', 'preferred', 'prefer')
standard	('standards', 'standardization', 'standardize', 'standard')
interfac	('interfaces',)
unexpect	('unexpected',)
loss	('loss', 'losses')
when	('when',)
integr	('integrated', 'integrate', 'integration', 'integrity', 'integral', 'integrating', 'integrations')
current	('current', 'currently')
project	('projections', 'projects', 'project', 'projected')
futur	('future',)
event	('events', 'event')
trend	('trends', 'trend')
believ	('believes', 'believe', 'believed')
affect	('affect', 'affected', 'affects', 'affecting')
strategi	('strategy', 'strategies')
short-term	('short-term',)
long-term	('long-term',)
object	('objectives', 'objective', 'objectively', 'objectivity', 'objects')
reli	('rely', 'relies')
upon	('upon',)
predict	('predictions', 'prediction', 'predictive', 'predict', 'predicting')
discuss	('discussed', 'discussion', 'discussions', 'discuss', 'discusses', 'discussing')
occur	('occur', 'occurs', 'occurred', 'occurring')
advers	('adversely', 'adverse')
those	('those',)
anticip	('anticipated', 'anticipate', 'anticipation', 'anticipates', 'anticipating')
impli	('implied',)
although	('although',)
reflect	('reflected', 'reflect', 'reflecting', 'reflects', 'reflections')
reason	('reasonable', 'reason', 'reasons', 'reasonably', 'reasonableness')
compani	('company', 'companys', 'companies')
cannot	('cannot',)
guarante	('guarantee', 'guarantees', 'guaranteed')
level	('levels', 'level')
activ	('activity', 'activities', 'active')
achiev	('achievements', 'achieves', 'achieve', 'achievement', 'achieving', 'achieved')
circumst	('circumstances',)
requir	('required', 'requires', 'requirements', 'require', 'requirement', 'requiring')
disclaim	('disclaims',)
oblig	('obligation', 'obligations', 'obligate')
complet	('complete', 'completed', 'completing', 'completion', 'completely', 'completeness')
pleas	('please',)
refer	('refer', 'reference', 'referred', 'refers', 'references')
report	('reports', 'report', 'reporting', 'reporter', 'reporters', 'reported', 'reportable')
file	('file', 'files', 'filed', 'filings', 'filing')
sec	('sec', 'secs')
recent	('recent', 'recently')
form	('form', 'formed', 'forms', 'forming')
10-k	('10-k',)
quarterli	('quarterly',)
10-q	('10-q',)
8-k	('8-k',)
copi	('copies', 'copy')
post	('posted', 'post')
websit	('website', 'websites')
without	('without',)
charg	('charge', 'charges', 'charged')
mani	('many',)
describ	('described', 'describe', 'describes')
remain	('remain', 'remains', 'remained', 'remaining')
stage	('stages',)
offer	('offered', 'offering', 'offerings', 'offer', 'offers')
when-and-if-avail	('when-and-if-available',)
basi	('basis',)
intend	('intended', 'intend', 'intends')
interpret	('interpreted', 'interpretation', 'interpret', 'interpretations')
commit	('commitment', 'committed', 'commitments')
promis	('promise', 'promising')
legal	('legal', 'legally')
releas	('release', 'releases', 'released')
function	('functionalities', 'functions', 'functional', 'function', 'functionally', 'functionality', 'functioning')
sole	('sole', 'solely')
discret	('discretion', 'discrete')
have	('have', 'having')
no	('no', 'nos')
liabil	('liability', 'liabilities')
failur	('failure', 'failures')
deliv	('deliver', 'delivers', 'delivering', 'delivered')
delay	('delay', 'delays', 'delayed')
deliveri	('delivery', 'deliveries')
set	('set', 'sets', 'setting', 'settings')
forth	('forth',)
use	('uses', 'useful')
non-gaap	('non-gaap',)
measur	('measures', 'measured', 'measuring', 'measure', 'measurement')
gross	('gross',)
profit	('profit', 'profitable', 'profits', 'profitability')
margin	('margin', 'margins', 'marginal')
expens	('expenses', 'expense', 'expensive', 'expensed')
incom	('income', 'incoming')
non-	('non-',)
gaap	('gaap',)
net	('net',)
dilut	('diluted', 'dilution', 'dilutive')
earn	('earnings', 'earn', 'earned')
per	('per',)
share	('share', 'shares', 'shared', 'sharing')
free	('free',)
cash	('cash',)
flow	('flow', 'flows')
understand	('understanding', 'understand', 'understands', 'understandings')
meant	('meant',)
isol	('isolation',)
substitut	('substitute', 'substituted', 'substitution', 'substitutes')
prepar	('prepared', 'preparing', 'preparation', 'prepares', 'prepare')
accord	('accordance', 'according')
further	('further',)
relev	('relevant',)
reconcili	('reconciliations', 'reconciliation')
compar	('comparable', 'compared', 'comparably', 'compare', 'compares', 'comparing')
found	('found', 'founded', 'founding')
slide	('slide',)
titl	('titled', 'title', 'titles')
content	('content', 'contents')
•	('•',)
summari	('summary',)
key	('key', 'keys')
announc	('announcements', 'announced', 'announcement', 'announce')
overview	('overview',)
highlight	('highlights',)
total	('total', 'totaled', 'totaling')
revenu	('revenue', 'revenues')
up	('up',)
101%	('101%',)
y	('y',)
$13	('$13',)
51b	('51b',)
abov	('above',)
$11	('$11',)
00b	('00b',)
+	('+',)
2%	('2%',)
171%	('171%',)
$10	('$10',)
32b	('32b',)
22%	('22%',)
$2	('$2',)
49b	('49b',)
record	('record', 'records', 'recorded', 'recording')
tremend	('tremendous',)
platform	('platforms', 'platform')
internet	('internet',)
invest	('investments', 'invested', 'investment', 'invest', 'investing')
purpose-built	('purpose-built',)
alreadi	('already',)
signific	('significant', 'significance')
drive	('driving', 'drive', 'drives')
strong	('strong',)
consumpt	('consumption',)
nvidia-pow	('nvidia-powered',)
instanc	('instances', 'instance')
well	('well', 'wells')
on-prem	('on-prem',)
fuel	('fueled', 'fueling', 'fuel')
geforc	('geforce',)
40	('40',)
seri	('series',)
laptop	('laptops', 'laptop')
end-custom	('end-customer',)
wa	('was',)
solid	('solid',)
consist	('consistent', 'consists', 'consisting', 'consisted', 'consistently', 'consist', 'consistency')
back-to-school	('back-to-school',)
led	('led',)
4060	('4060',)
launch	('launched', 'launch')
ti	('ti',)
ada	('ada', 'adas')
lovelac	('lovelace',)
down	('down',)
price	('price', 'prices', 'pricing', 'priced')
point	('points', 'point')
low	('low', 'lowes')
$299	('$299',)
dollar	('dollar', 'dollars')
figur	('figures',)
million	('millions', 'million')
than	('than',)
ep	('eps',)
appendix	('appendix',)
q	('q',)
507	('507',)
+101%	('+101%',)
+88%	('+88%',)
70	('70',)
1%	('1%',)
+26	('+26',)
6	('6',)
pt	('pts',)
+5	('+5',)
5	('5',)
71	('71',)
+25	('+25',)
3	('3',)
+4	('+4',)
4	('4',)
$6	('$6',)
800	('800',)
+1	('+1',)
263%	('263%',)
+218%	('+218%',)
$7	('$7',)
776	('776',)
+487%	('+487%',)
+155%	('+155%',)
188	('188',)
+843%	('+843%',)
+203%	('+203%',)
740	('740',)
+422%	('+422%',)
+148%	('+148%',)
48	('48',)
+854%	('+854%',)
+202%	('+202%',)
+429%	('+429%',)
op	('ops',)
348	('348',)
+400%	('+400%',)
+118%	('+118%',)
704	('704',)
$5	('$5',)
931	('931',)
051	('051',)
192	('192',)
45	('45',)
9%	('9%',)
56	('56',)
66	('66',)
8%	('8%',)
0%	('0%',)
50	('50',)
55	('55',)
60	('60',)
65	('65',)
75	('75',)
80	('80',)
85	('85',)
90	('90',)
1	('1',)
500	('500',)
7	('7',)
9	('9',)
11	('11',)
13	('13',)
15	('15',)
fy23	('fy23',)
q3	('q3',)
q4	('q4',)
q1	('q1',)
$m	('$m',)
gm	('gm',)
nearli	('nearly',)
tripl	('tripled',)
year-on-year	('year-on-year',)
primarili	('primarily',)
aw	('aws',)
googl	('google',)
meta	('meta',)
microsoft	('microsoft', 'microsofts')
azur	('azure',)
oracl	('oracle',)
network	('networking', 'network', 'networks')
almost	('almost',)
doubl	('doubled',)
end-to-end	('end-to-end',)
infiniband	('infiniband',)
bluefield-3	('bluefield-3',)
dpu	('dpu', 'dpus')
qualif	('qualification', 'qualifications')
major	('major', 'majority')
oem	('oems', 'oem')
multipl	('multiple', 'multiples')
$3	('$3',)
806	('806',)
833	('833',)
616	('616',)
$4	('$4',)
284	('284',)
323	('323',)
141%	('141%',)
just	('just',)
47%	('47%',)
instal	('installed', 'installments')
3060	('3060',)
higher	('higher',)
gpu-pow	('gpu-powered',)
gain	('gained', 'gains', 'gain', 'gainful')
popular	('popularity', 'popular')
shipment	('shipments', 'shipment')
now	('now',)
outpac	('outpace',)
sever	('several', 'severance', 'severe')
region	('regions', 'regional', 'region')
around	('around',)
like	('likely', 'like')
bit	('bit',)
stronger	('stronger',)
holiday	('holiday', 'holidays')
build	('build', 'building', 'builds', 'buildings')
schedul	('schedules', 'schedule', 'scheduled')
35	('35',)
ad	('added', 'adding')
support	('support', 'supported', 'supporting', 'supports', 'supportive')
diablo	('diablo',)
iv	('iv',)
baldur	('baldurs',)
gate	('gate',)
there	('there',)
over	('over',)
330	('330',)
app	('apps',)
avatar	('avatar', 'avatars')
engin	('engine', 'engineers', 'engineering', 'engineer')
ace	('ace',)
042	('042',)
$1	('$1',)
574	('574',)
831	('831',)
240	('240',)
486	('486',)
11%	('11%',)
$496	('$496',)
$200	('$200',)
$226	('$226',)
$295	('$295',)
$379	('$379',)
drove	('drove',)
roll	('rolling',)
out	('out',)
initi	('initially', 'initial', 'initiative', 'initiatives', 'initiated', 'initiate')
come	('coming', 'comes', 'come')
power	('powerful', 'powering', 'powered', 'power', 'powers')
6000	('6000',)
configur	('configured', 'configurations', 'configurators', 'configuring', 'configuration')
three	('three',)
5000	('5000',)
4500	('4500',)
4000	('4000',)
workload	('workloads', 'workload')
gen	('gen',)
llm	('llm', 'llms')
scienc	('science', 'sciences')
pro	('pro',)
viz	('viz',)
28%	('28%',)
24%	('24%',)
$220	('$220',)
$251	('$251',)
$294	('$294',)
$296	('$296',)
$253	('$253',)
self-driv	('self-driving',)
orin	('orin',)
soc	('soc', 'socs')
energi	('energy',)
vehicl	('vehicle', 'vehicles')
maker	('makers', 'maker')
declin	('decline', 'declines', 'declined')
lower	('lower',)
particularli	('particularly',)
china	('china', 'chinas')
xpeng	('xpeng',)
g6	('g6',)
coup	('coupe',)
suv	('suvs',)
intellig	('intelligent', 'intelligence')
assist	('assistance', 'assistants', 'assistant', 'assisting', 'assist', 'assists')
line	('line',)
chiplet	('chiplets', 'chiplet')
15%	('15%',)
sourc	('sources', 'source', 'sourcing')
270	('270',)
$392	('$392',)
249	('249',)
911	('911',)
were	('were',)
both	('both',)
4b	('4b',)
sharehold	('shareholders', 'shareholder')
repurchas	('repurchased', 'repurchases', 'repurchase')
$300m	('$300m',)
capex	('capex',)
princip	('principal',)
payment	('payments', 'payment')
pp&e	('pp&e',)
$16	('$16',)
0b	('0b',)
$9	('$9',)
8b	('8b',)
debt	('debt',)
2b	('2b',)
addit	('additional', 'addition', 'additionally', 'additions')
$25b	('$25b',)
stock	('stock',)
author	('authorized', 'authority', 'authorizes', 'authorizing', 'authorities', 'authorizations', 'authorization')
$4b	('$4b',)
defin	('defined', 'define')
equival	('equivalents', 'equivalent')
secur	('securities', 'securely', 'security', 'secure')
less	('less',)
400%	('400%',)
118%	('118%',)
0	('0',)
billion	('billion', 'billions')
plu	('plus',)
minu	('minus',)
5%	('5%',)
72	('72',)
approxim	('approximately', 'approximating', 'approximate', 'approximates')
95	('95',)
00	('00',)
$100	('$100',)
exclud	('excluding', 'exclude', 'excludes', 'excluded')
non-affili	('non-affiliated', 'non-affiliates')
14	('14',)
item	('items', 'item')
grace	('grace',)
superchip	('superchips', 'superchip')
gh200	('gh200',)
combin	('combines', 'combination', 'combined', 'combining', 'combinations', 'combine')
first	('first',)
arm-bas	('arm-based',)
cpu	('cpu', 'cpus')
h100	('h100',)
nvlink-c2c	('nvlink-c2c',)
interconnect	('interconnect', 'interconnects')
900gb	('900gb',)
s	('s',)
7x	('7x',)
faster	('faster',)
pcie	('pcie',)
gen5	('gen5',)
cpu+gpu	('cpu+gpu',)
coher	('coherent',)
access	('access', 'accessible', 'accessing', 'accessed')
600gb	('600gb',)
memori	('memory',)
ideal	('ideal',)
giant	('giant',)
hpc	('hpc',)
deep	('deep',)
recommend	('recommenders', 'recommender', 'recommendation', 'recommendations', 'recommending', 'recommend', 'recommends', 'recommended')
vector	('vector',)
databas	('databases', 'database')
order-of-magnitud	('order-of-magnitude',)
x86	('x86',)
9x	('9x',)
12x	('12x',)
infer	('inference',)
284x	('284x',)
65b	('65b',)
paramet	('parameter', 'parameters')
lead	('leading', 'lead', 'leads')
server	('server', 'servers')
softbank	('softbank',)
5g	('5g',)
6g	('6g',)
dgx	('dgx',)
supercomput	('supercomputer', 'supercomputers', 'supercomputing')
extend	('extends', 'extended', 'extend', 'extending')
frontier	('frontier', 'frontiers')
class	('class', 'classes')
large-memori	('large-memory',)
256	('256',)
nvlink	('nvlink',)
switch	('switch', 'switches')
massiv	('massive', 'massively')
space	('space',)
exaflop	('exaflop',)
144tb	('144tb',)
next-gen	('next-gen',)
languag	('language', 'languages')
model	('models', 'model', 'modeling')
analyt	('analytics',)
work	('work', 'working', 'worked', 'works')
togeth	('together',)
among	('among',)
calendar	('calendar',)
hbm3e	('hbm3e',)
two	('two',)
connect	('connected', 'connects', 'connect', 'connections', 'connection', 'connectivity', 'connecting')
compris	('comprises', 'comprising', 'comprised', 'comprise')
singl	('single',)
144	('144',)
arm	('arm',)
neovers	('neoverse',)
core	('cores', 'core')
eight	('eight',)
petaflop	('petaflops',)
282	('282',)
gigabyt	('gigabytes', 'gigabyte')
5x	('5x',)
capac	('capacity', 'capacities')
3x	('3x',)
bandwidth	('bandwidth',)
predecessor	('predecessor',)
built	('built',)
complex	('complex', 'complexity')
l40	('l40s', 'l40')
univers	('universal', 'universe', 'universities', 'university', 'universitys')
processor	('processor', 'processors')
compute-intens	('compute-intensive',)
train	('training', 'train', 'trained')
3d	('3d', '3ds')
video	('video', 'videos')
process	('processing', 'process', 'processed', 'processes')
broad	('broad',)
rang	('range', 'ranging', 'ranges')
ovx	('ovx',)
ai-readi	('ai-ready',)
bluefield	('bluefield',)
begin	('beginning', 'begin')
mgx	('mgx',)
scalabl	('scalable', 'scalability')
open	('open', 'opens', 'opened', 'opening')
quickli	('quickly',)
cost-effect	('cost-effectively', 'cost-effective')
100	('100', '100s')
variat	('variations',)
address	('address', 'addressed', 'addressing', 'addresses')
divers	('diverse', 'diversity', 'diversion')
slash	('slashes',)
three-quart	('three-quarters',)
reduc	('reduces', 'reducing', 'reduced', 'reduce')
two-third	('two-thirds',)
six	('six',)
month	('months', 'month')
virtual	('virtually', 'virtual')
segment	('segment', 'segments')
$1t	('$1t',)
asrock	('asrock',)
rack	('rack', 'racks')
asu	('asus',)
pegatron	('pegatron',)
qct	('qct',)
supermicro	('supermicro',)
spectrum-x	('spectrum-x',)
ethernet	('ethernet',)
optim	('optimize', 'optimized', 'optimizing', 'optimization', 'optimizations')
effici	('efficiency', 'efficiently', 'efficient')
ethernet-bas	('ethernet-based',)
spectrum-4	('spectrum-4',)
linkx	('linkx',)
doca	('doca',)
programm	('programmability', 'programmable')
better	('better',)
vs	('vs',)
tradit	('traditional', 'traditionally')
ship	('shipping', 'ship', 'shipped')
custom	('custom', 'customize', 'customizing', 'customers', 'customized', 'customer', 'customization')
workbench	('workbench',)
unifi	('unified',)
easy-to-us	('easy-to-use',)
workspac	('workspace',)
allow	('allows', 'allow', 'allowed', 'allowing', 'allowances', 'allowance')
creat	('create', 'creating', 'created', 'creates')
pretrain	('pretrained',)
pc	('pc', 'pcs')
then	('then',)
them	('them',)
public	('public', 'publication')
latest	('latest',)
version	('version', 'versions')
nemo	('nemo',)
cloud-n	('cloud-native',)
framework	('framework', 'frameworks')
foundat	('foundation', 'foundational', 'foundations')
production-readi	('production-ready',)
hug	('hugging',)
face	('face', 'facing', 'faced')
give	('give', 'gives', 'giving')
one-click	('one-click',)
tune	('tune',)
vmware	('vmware',)
call	('called', 'calls', 'call')
privat	('private', 'privately')
fulli	('fully',)
multi-cloud	('multi-cloud',)
run	('running', 'run', 'runs')
manag	('management', 'managements', 'managing', 'managers', 'manage', 'managed', 'manages', 'manager')
such	('such',)
chatbot	('chatbots', 'chatbot')
search	('search',)
summar	('summarization', 'summarize', 'summarizes', 'summarized', 'summarizing')
enterprise-readi	('enterprise-ready',)
soon	('soon',)
dell	('dell',)
hpe	('hpe',)
lenovo	('lenovo',)
snowflak	('snowflake',)
team	('team', 'teams')
har	('harness', 'harnesses')
path	('path', 'paths')
own	('own', 'owned', 'owning', 'owns')
proprietari	('proprietary',)
gpu-acceler	('gpu-accelerated',)
make	('make', 'making', 'makes')
wpp	('wpp', 'wpps')
ai-en	('ai-enabled',)
advertis	('advertising',)
creativ	('creative',)
produc	('produce',)
high-qual	('high-quality',)
commerci	('commercial', 'commercially')
chain	('chain', 'chains')
tool	('tools', 'tool')
adob	('adobe',)
firefli	('firefly',)
famili	('family', 'families')
exclus	('exclusive', 'exclusively', 'exclusions', 'exclusion')
getti	('getty',)
imag	('images', 'image', 'imaging')
picasso	('picasso',)
foundri	('foundry', 'foundries', 'foundrys')
client	('clients',)
creation	('creation',)
builder	('builders',)
boxx	('boxx',)
hp	('hp',)
four	('four',)
828	('828',)
tflop	('tflops',)
192gb	('192gb',)
2x	('2x',)
rt	('rt',)
throughput	('throughput',)
versu	('versus',)
prior	('prior',)
fall	('fall',)
pixar	('pixar', 'pixars')
appl	('apple',)
autodesk	('autodesk',)
co-found	('co-founded',)
allianc	('alliance', 'alliances')
openusd	('openusd',)
aousd	('aousd',)
promot	('promote', 'promotions', 'promoting', 'promotes', 'promotion', 'promoted')
evolut	('evolution',)
scene	('scene', 'scenes')
descript	('description',)
capabl	('capabilities', 'capability', 'capable')
creator	('creators',)
compos	('compose', 'composed')
simul	('simulate', 'simulation', 'simulations', 'simulating', 'simulates')
large-scal	('large-scale',)
3d-enabl	('3d-enabled',)
greater	('greater',)
interoper	('interoperability',)
api	('apis',)
seamlessli	('seamlessly',)
implement	('implement', 'implemented', 'implementation', 'implementing', 'implements')
chatusd	('chatusd',)
copilot	('copilot',)
usd	('usd',)
answer	('answer', 'answers', 'answered', 'answering')
knowledg	('knowledge', 'knowledgeable')
question	('questions', 'question', 'questionable')
python-usd	('python-usd',)
code	('code', 'coding')
script	('scripts',)
runusd	('runusd',)
translat	('translates', 'translation', 'translating', 'translate')
path-trac	('path-traced',)
render	('rendered', 'renders', 'rendering', 'render')
deepsearch	('deepsearch',)
agent	('agent', 'agents')
fast	('fast',)
semant	('semantic',)
untag	('untagged',)
asset	('assets', 'asset')
usd-gdn	('usd-gdn',)
publish	('publisher', 'publishing', 'publish', 'published', 'publishers')
stream	('streaming', 'stream')
high-fidel	('high-fidelity',)
openusd-bas	('openusd-based',)
experi	('experiences', 'experience')
graphic	('graphics',)
transform	('transform', 'transformer', 'transformers', 'transforms', 'transformational', 'transformative', 'transformation', 'transforming')
automobil	('automobiles', 'automobile')
mainstream	('mainstream',)
ip	('ip',)
al	('al',)
safeti	('safety',)
ultra-fast	('ultra-fast',)
os	('os',)
ix	('ix',)
cuda	('cuda',)
tensorrt	('tensorrt',)
cover	('covers', 'covered', 'covering', 'cover')
wide	('wide', 'widely')
luxuri	('luxury',)
entry-level	('entry-level',)
pioneer	('pioneered',)
solv	('solve',)
challeng	('challenges', 'challenge', 'challenging')
classic	('classical',)
centuri	('century',)
lift	('lifts',)
off	('off', 'offs')
hundr	('hundred', 'hundreds')
74%	('74%',)
top500	('top500',)
boast	('boasts',)
headquart	('headquarters', 'headquartered', 'headquarter')
santa	('santa',)
clara	('clara',)
ca	('ca',)
superfast	('superfast',)
chip	('chip', 'chips')
full-stack	('full-stack',)
special	('specialized', 'special', 'specialize')
algorithm	('algorithms',)
librari	('libraries', 'library')
domain	('domain', 'domains')
expert	('experts', 'expert')
refactor	('refactor', 'refactoring')
part	('parts',)
approach	('approach', 'approaches')
silicon	('silicon',)
exampl	('example', 'examples')
if	('if',)
90%	('90%',)
runtim	('runtime',)
100x	('100x',)
sped	('sped',)
99%	('99%',)
50x	('50x',)
80%	('80%',)
500x	('500x',)
even	('even',)
1000x	('1000x',)
amdahl	('amdahls',)
proport	('proportion', 'proportions', 'proportional')
execut	('execution', 'executive', 'executives', 'execute', 'executed')
p	('p',)
\u0001d446=	('\\u0001d446=',)
\u2212\u0001d45d+	('\\u2212\\u0001d45d+',)
\u0001d45d	('\\u0001d45d',)
\u0001d460	('\\u0001d460',)
whi	('why',)
climat	('climate',)
drug	('drug', 'drugs')
discoveri	('discovery',)
ray	('ray',)
trace	('tracing',)
uniqu	('uniquely', 'unique')
dedic	('dedicated', 'dedicate')
top-to-bottom	('top-to-bottom',)
bottom-to-top	('bottom-to-top',)
invent	('inventing', 'invention', 'invents', 'inventions', 'invented')
tensor	('tensor',)
know	('know', 'knows')
john	('john',)
hennessi	('hennessy',)
oct	('oct',)
23	('23',)
2018	('2018',)
dead	('dead',)
jensen	('jensen',)
huang	('huang', 'huangs')
gtc	('gtc',)
2013	('2013',)
post-moor	('post-moores',)
10	('10', '10s')
2	('2',)
8	('8',)
1980	('1980',)
1990	('1990',)
2000	('2000',)
2010	('2010',)
2020	('2020',)
2030	('2030',)
gpu-comput	('gpu-computing',)
perf	('perf',)
single-thread	('single-threaded',)
1x	('1x',)
trillion	('trillions', 'trillion')
second	('second',)
top	('tops', 'top')
innov	('innovation', 'innovators', 'innovated', 'innovations')
decad	('decades', 'decade')
singular	('singular',)
focu	('focus',)
million-x	('million-x',)
problem	('problem', 'problems')
layer	('layer', 'layers')
multi-gpu	('multi-gpus',)
multi-nod	('multi-nodes', 'multi-node')
center-scal	('center-scale',)
treat	('treating', 'treated')
storag	('storage',)
fabric	('fabric', 'fabrication')
edg	('edge',)
environ	('environments', 'environment')
cunumer	('cunumeric',)
cv-cuda	('cv-cuda',)
cuquantum	('cuquantum',)
parabrick	('parabricks',)
sionna	('sionna',)
jetpack	('jetpack',)
rapid	('rapids', 'rapid')
spark	('spark',)
cudnn	('cudnn',)
cugraph	('cugraph',)
triton	('triton',)
deepstream	('deepstream',)
flare	('flare',)
mag	('mag',)
io	('io',)
aerial	('aerial',)
egx	('egx',)
agx	('agx',)
super	('super',)
pod	('pod',)
igx	('igx',)
3-chip	('3-chips',)
cloud-to-edg	('cloud-to-edge',)
datacenter-to-	('datacenter-to-',)
300	('300',)
400	('400',)
startup	('startups', 'startup')
6k	('6k',)
14k	('14k',)
4m	('4m',)
8m	('8m',)
last	('last', 'lasted')
downloads*	('downloads*',)
40m	('40m',)
20m	('20m',)
*cumul	('*cumulative',)
000	('000',)
700	('700',)
multi-sid	('multi-sided',)
flywheel	('flywheel',)
best	('best',)
reach	('reach', 'reaching', 'reached', 'reaches')
rich	('rich',)
suit	('suite', 'suited')
let	('lets', 'let')
media	('media',)
entertain	('entertainment',)
healthcar	('healthcare',)
transport	('transportation',)
retail	('retail', 'retailer', 'retailers')
unmatch	('unmatched',)
speed	('speed',)
entir	('entire', 'entirely')
propel	('propelling', 'propel')
organ	('organizations', 'organization', 'organized')
wealth	('wealth',)
worldwid	('worldwide',)
960	('960',)
cpu-onli	('cpu-only',)
25x	('25x',)
84x	('84x',)
energy-effici	('energy-efficiency', 'energy-efficient')
re-engin	('re-engineered',)
magnum	('magnum',)
cuda-x	('cuda-x',)
bert-larg	('bert-large',)
dual-eypc	('dual-eypc',)
7763	('7763',)
dual-epyc	('dual-epyc',)
8x	('8x',)
l4	('l4',)
nvl	('nvl',)
functionally-saf	('functionally-safe',)
autonom	('autonomous',)
industrial-grad	('industrial-grade',)
logist	('logistics', 'logistical')
meet	('meeting', 'meetings', 'meet', 'meets')
transcript	('transcription',)
contact	('contact', 'contacted')
3b	('3b',)
minut	('minutes',)
day	('day', 'days')
500m	('500m',)
>1b	('>1b',)
smart	('smart',)
citi	('city', 'cities')
camera	('cameras',)
protect	('protection', 'protect', 'protections', 'protecting')
$94	('$94',)
5b	('5b',)
inventori	('inventory', 'inventories')
inspect	('inspection', 'inspections')
medic	('medical', 'medically')
$32m	('$32m',)
vision	('vision',)
sensor	('sensors', 'sensor')
10m	('10m',)
diagnost	('diagnostic',)
scan	('scans',)
10t	('10t',)
mile	('miles',)
credit	('credit', 'credited', 'credits')
card	('card', 'cards')
fraud	('fraud',)
28b	('28b',)
transact	('transactions', 'transaction', 'transactional')
1b	('1b',)
e-commerc	('e-commerce',)
visitor	('visitors',)
fundament	('fundamentally', 'fundamental')
refin	('refining', 'refine', 'refinance', 'refinement')
learn	('learned', 'learn', 'learning', 'learns')
percept	('perception', 'perceptions')
speech	('speech',)
buy	('buy',)
late	('late',)
2022	('2022',)
chatgpt	('chatgpt',)
usher	('ushered',)
text	('text',)
protein	('proteins',)
twin	('twins', 'twin')
interact	('interacts', 'interactive', 'interactions')
physic	('physical', 'physically', 'physics')
world-class	('world-class',)
nilson	('nilson',)
ih	('ihs',)
markit	('markit',)
similar	('similar',)
web	('web',)
nrf	('nrf',)
who	('who',)
abi	('abi',)
intern	('internal', 'international', 'internally', 'internationally')
analysi	('analysis',)
effort	('efforts', 'effort')
emul	('emulate',)
behavior	('behavior', 'behaviors')
real-tim	('real-time',)
via	('via',)
descriptor	('descriptor',)
html	('html',)
portal	('portals',)
av	('av',)
warehous	('warehouse', 'warehouses')
connector	('connectors',)
brows	('browsing',)
architect	('architects', 'architect')
hardwar	('hardware',)
supply-chain	('supply-chain',)
planner	('planners', 'planner')
data-driven	('data-driven',)
licens	('license', 'licensed', 'licensing', 'licenses')
modern	('modern', 'modernizing')
e	('e',)
g	('g',)
merlin	('merlin',)
monai	('monai',)
metropoli	('metropolis',)
cuopt	('cuopt',)
morpheu	('morpheus',)
tokkio	('tokkio',)
nvidia-host	('nvidia-hosted',)
edifi	('edify',)
start	('start', 'starting', 'starts', 'started')
prompt	('prompts', 'prompted')
streamlin	('streamlines',)
biomolecular	('biomolecular',)
chemistri	('chemistry',)
rna	('rna',)
dna	('dna',)
bionemo	('bionemo',)
research	('researchers', 'research', 'researcher')
biotech	('biotech',)
pharma	('pharma',)
chemic	('chemical', 'chemicals')
biolog	('biological', 'biology')
dataset	('datasets',)
specif	('specific', 'specification', 'specifically', 'specifications')
task	('task', 'tasks')
document	('documents', 'document', 'documenting')
write	('write', 'writing', 'writes')
analyz	('analyze', 'analyzed')
sentiment	('sentiment',)
paraphras	('paraphrase',)
thousand	('thousands', 'thousand')
do	('do', 'doing')
platform-as-a-servic	('platform-as-a-service',)
infrastructure-as-a-servic	('infrastructure-as-a-service',)
prem	('prem',)
hybrid	('hybrid',)
multi	('multi',)
go-to-market	('go-to-market',)
on-premis	('on-premises',)
everywher	('everywhere',)
$150b	('$150b',)
$100b	('$100b',)
$300b	('$300b',)
gamer	('gamers', 'gamer')
spend	('spending',)
consol	('consoles', 'console')
50m	('50m',)
per-serv	('per-server',)
per-year	('per-year',)
subscript	('subscription', 'subscriptions')
45m	('45m',)
per-us	('per-user',)
nic	('nics',)
100m	('100m',)
43	('43',)
42	('42',)
proviz	('proviz',)
auto	('auto',)
716	('716',)
918	('918',)
675	('675',)
$26	('$26',)
914	('914',)
974	('974',)
$20	('$20',)
699	('699',)
fy19	('fy19',)
fy20	('fy20',)
fy21	('fy21',)
fy22	('fy22',)
1h	('1h',)
januari	('january',)
round	('rounded',)
nearest	('nearest',)
percent	('percent',)
metric	('metrics', 'metric')
relat	('related', 'relations', 'relating', 'relate', 'relation', 'relates')
reserv	('reserves', 'reserve', 'reserved', 'reservation')
407	('407',)
735	('735',)
803	('803',)
$12	('$12',)
690	('690',)
040	('040',)
38%	('38%',)
34%	('34%',)
41%	('41%',)
52%	('52%',)
30%	('30%',)
40%	('40%',)
50%	('50%',)
60%	('60%',)
70%	('70%',)
$0	('$0',)
$15	('$15',)
233	('233',)
821	('821',)
947	('947',)
$17	('$17',)
969	('969',)
965	('965',)
$14	('$14',)
417	('417',)
62%	('62%',)
63%	('63%',)
66%	('66%',)
67%	('67%',)
59%	('59%',)
55%	('55%',)
65%	('65%',)
75%	('75%',)
$18	('$18',)
comparison	('comparison', 'comparisons')
a100	('a100',)
intel	('intel',)
categori	('category', 'categories')
mlperf	('mlperf',)
benchmark	('benchmark',)
incred	('incredible', 'incredibly')
dramat	('dramatic',)
node	('nodes', 'node')
$4m	('$4m',)
replac	('replace', 'replacement')
920	('920',)
$50m	('$50m',)
carri	('carry', 'carrying', 'carried')
determin	('determination', 'determines', 'determining', 'determine', 'determined', 'determinations', 'determinable')
board	('board', 'boards')
director	('directors', 'director')
7b	('7b',)
$8	('$8',)
$10b	('$10b',)
$398m	('$398m',)
fy	('fy',)
maintain	('maintain', 'maintained', 'maintaining', 'maintains')
strateg	('strategic',)
talent	('talent', 'talented')
capit	('capital', 'capitalization', 'capitalized', 'capitalize', 'capitalizations')
alloc	('allocation', 'allocated', 'allocable', 'allocate', 'allocating', 'allocates')
glanc	('glance',)
5-yr	('5-yr',)
cagr	('cagr',)
51%	('51%',)
10%	('10%',)
9b	('9b',)
hyperion	('hyperion',)
full	('full',)
cockpit	('cockpit',)
quadro	('quadro',)
33%	('33%',)
56%	('56%',)
6%	('6%',)
3%	('3%',)
932	('932',)
983	('983',)
696	('696',)
613	('613',)
005	('005',)
607	('607',)
leader	('leader', 'leaders')
#1	('#1',)
hyperscal	('hyperscale', 'hyperscaler')
rise	('rising', 'rise')
data-cent	('data-center',)
input	('input', 'inputs')
output	('output',)
today	('todays', 'today')
involv	('involving', 'involvement', 'involved', 'involves', 'involve')
time-consum	('time-consuming',)
technic	('technical',)
distribut	('distributed', 'distribution', 'distributions', 'distributing', 'distribute')
alexnet	('alexnet',)
vgg-19	('vgg-19',)
seq2seq	('seq2seq',)
resnet	('resnet',)
inceptionv3	('inceptionv3',)
xception	('xception',)
resnext	('resnext',)
densenet201	('densenet201',)
elmo	('elmo',)
moco	('moco',)
resnet50	('resnet50',)
wav2vec	('wav2vec',)
gpt-1	('gpt-1',)
bert	('bert',)
gpt-2	('gpt-2',)
xlnet	('xlnet',)
megatron	('megatron',)
t-nlg	('t-nlg',)
gpt-3	('gpt-3',)
megatron-tur	('megatron-turing',)
nlg	('nlg',)
530b	('530b',)
2012	('2012',)
2014	('2014',)
2015	('2015',)
2016	('2016',)
2017	('2017',)
2019	('2019',)
2021	('2021',)
2yr	('2yrs',)
275x	('275x',)
giant-scal	('giant-scale',)
246	('246',)
518	('518',)
759	('759',)
462	('462',)
067	('067',)
726	('726',)
steam	('steam',)
200m+	('200m+',)
richer	('richer',)
mix	('mix',)
ture	('turing',)
$699+	('$699+',)
3yr	('3yr',)
asp	('asp',)
unit	('units', 'unit', 'united')
20%	('20%',)
rtx3060+	('rtx3060+',)
cumul	('cumulative',)
sell-through	('sell-through',)
$	('$',)
12	('12',)
16	('16',)
17	('17',)
18	('18',)
19	('19',)
20	('20',)
week	('weeks', 'week')
after	('after',)
estim	('estimates', 'estimated', 'estimate', 'estimating')
3060+	('3060+',)
90%+	('90%+',)
130	('130',)
212	('212',)
053	('053',)
111	('111',)
544	('544',)
$674	('$674',)
$641	('$641',)
$700	('$700',)
$536	('$536',)
$566	('$566',)
$903	('$903',)
$549	('$549',)
infotain	('infotainment',)
next-gener	('next-generation',)
thor	('thor',)
fy26	('fy26',)
central	('centralized', 'central')
car	('car', 'cars')
software-defin	('software-defined',)
merced	('mercedes',)
benz	('benz',)
jaguar	('jaguar',)
land	('land',)
rover	('rover',)
$14b	('$14b',)
horizon	('horizon',)
neta	('neta',)
balanc	('balance', 'balancing', 'balances', 'balanced')
743	('743',)
761	('761',)
822	('822',)
108	('108',)
641	('641',)
143	('143',)
272	('272',)
677	('677',)
049	('049',)
750	('750',)
422	('422',)
897	('897',)
561	('561',)
21	('21',)
208	('208',)
296	('296',)
corpor	('corporate', 'corporation', 'corporations')
respons	('responsibility', 'responsible', 'response', 'responsibilities', 'responsibly', 'responses', 'responsive')
magazin	('magazines',)
influenti	('influential',)
workplac	('workplaces',)
fortun	('fortunes', 'fortune')
admir	('admired',)
wall	('wall',)
street	('street',)
journal	('journals',)
250	('250',)
all-star	('all-stars',)
america	('americas', 'america')
cnbc	('cnbc',)
newsweek	('newsweek',)
place	('places', 'place', 'placed', 'placing')
lgbt	('lgbt',)
equal	('equality', 'equal', 'equaled', 'equally')
human	('human', 'humanitys', 'humans')
right	('rights', 'right')
campaign	('campaign',)
typic	('typically',)
20x	('20x',)
fy25	('fy25',)
peopl	('people',)
life	('lifes', 'life')
consciou	('conscious',)
least	('least',)
scope	('scope',)
ghg	('ghg',)
emiss	('emissions',)
43%	('43%',)
gender	('gender',)
racial	('racially', 'racial')
ethnic	('ethnically', 'ethnicity', 'ethnic', 'ethnicities')
93%	('93%',)
independ	('independent', 'independence', 'independently')
govern	('governance', 'government', 'governments', 'governing', 'govern')
acquisition-rel	('acquisition-related',)
stock-bas	('stock-based',)
compens	('compensation', 'compensated', 'compensate')
b	('b',)
ip-rel	('ip-related',)
c	('c',)
adjust	('adjustments', 'adjusted', 'adjust', 'adjusting', 'adjustment')
614	('614',)
119	('119',)
31	('31',)
137	('137',)
842	('842',)
363	('363',)
calcul	('calculation', 'calculated', 'calculating')
499	('499',)
amort	('amortization', 'amortize', 'amortized')
intang	('intangible', 'intangibles')
good	('goods', 'good')
sold	('sold',)
sale	('sales', 'sale')
administr	('administrative', 'administration', 'administrator', 'administratively')
held	('held',)
contd	('contd',)
fy2023	('fy2023',)
53	('53',)
63	('63',)
fy2024	('fy2024',)
64	('64',)
percentag	('percentage', 'percentages')
27	('27',)
171	('171',)
61	('61',)
7%	('7%',)
39	('39',)
768	('768',)
62	('62',)
425	('425',)
88	('88',)
38	('38',)
396	('396',)
344	('344',)
141	('141',)
475	('475',)
455	('455',)
138	('138',)
356	('356',)
59	('59',)
636	('636',)
214	('214',)
76	('76',)
346	('346',)
57	('57',)
239	('239',)
58	('58',)
110	('110',)
69	('69',)
68	('68',)
step-up	('step-up',)
acquisit	('acquisition', 'acquisitions')
termin	('termination', 'terminates', 'terminated', 'terminate')
557	('557',)
804	('804',)
37	('37',)
32	('32',)
844	('844',)
846	('846',)
34	('34',)
26	('26',)
836	('836',)
397	('397',)
532	('532',)
004	('004',)
041	('041',)
47	('47',)
353	('353',)
674	('674',)
710	('710',)
224	('224',)
33	('33',)
280	('280',)
324	('324',)
227	('227',)
367	('367',)
311	('311',)
576	('576',)
941	('941',)
52	('52',)
settlement	('settlement', 'settlements')
restructur	('restructuring',)
purchas	('purchases', 'purchase', 'purchased', 'purchaser', 'purchasing')
properti	('property', 'properties')
equip	('equipment', 'equipped')
600	('600',)
489	('489',)
128	('128',)
976	('976',)
83	('83',)
794	('794',)
36	('36',)
001	('001',)
691	('691',)
537	('537',)
259	('259',)
950	('950',)
review	('review', 'reviews', 'reviewing', 'reviewed')
notic	('notice',)
proxi	('proxy', 'proxies')
reshap	('reshaping',)
societi	('society',)
diginomica	('diginomica',)
scientist	('scientists', 'scientist')
artist	('artists',)
adventur	('adventurers',)
take	('take', 'takes', 'taking')
tough	('tough',)
shape	('shape', 'shaping')
guid	('guided', 'guiding', 'guide')
us	('us',)
earth-2	('earth-2', 'earth-2s')
everyon	('everyone',)
cutting-edg	('cutting-edge',)
rig	('rig', 'rigs')
anyon	('anyone',)
smartphon	('smartphone', 'smartphones')
rent	('rent',)
play	('play', 'playing')
aaa	('aaa',)
fortnit	('fortnite',)
marvel	('marvels', 'marvell')
aveng	('avengers',)
look	('look', 'looking', 'looks')
they	('they',)
ever	('ever',)
befor	('before',)
invas	('invasion',)
stun	('stunning',)
ray-trac	('ray-traced',)
blockbust	('blockbusters',)
cyberpunk	('cyberpunk',)
2077	('2077',)
max	('max',)
blender	('blender',)
epic	('epic',)
unreal	('unreal', 'unrealized')
30	('30',)
high-end	('high-end',)
thin	('thin',)
light	('light',)
unleash	('unleashes',)
yet	('yet',)
mountain	('mountains',)
whole	('whole',)
type	('type', 'types')
emerg	('emerged', 'emerging', 'emerge', 'emergence')
becaus	('because',)
unveil	('unveiled',)
known	('known',)
convers	('conversational', 'conversion', 'conversely')
skill	('skills', 'skill', 'skilled')
state	('state', 'stated', 'states', 'stating')
art	('art', 'arts')
25	('25',)
hold	('holds', 'holding', 'hold', 'holdings')
kingdom	('kingdom',)
forb	('forbes',)
toy	('toy',)
maxin	('maxine',)
onlin	('online',)
ento	('entos',)
orbnet	('orbnet',)
graph	('graph', 'graphs')
neural	('neural',)
atom	('atomic',)
metavers	('metaverse',)
2d	('2d',)
cloud-bas	('cloud-based',)
phase	('phase', 'phases')
fuse	('fused',)
touch	('touch',)
accur	('accurate', 'accurately')
photorealist	('photorealistic',)
planet	('planet',)
earth	('earth', 'earths')
bmw	('bmw',)
group	('group', 'groups')
lockhe	('lockheed',)
martin	('martin',)
siemen	('siemens',)
pepsico	('pepsico',)
ericsson	('ericsson',)
amazon	('amazon',)
anym	('anymal',)
eth	('eth',)
zurich	('zurichs',)
four-leg	('four-legged',)
walk	('walk',)
wheel	('wheels',)
jetson	('jetson',)
isaac	('isaac',)
gym	('gym',)
glimps	('glimpse',)
machin	('machines', 'machine')
everyth	('everything',)
move	('moves', 'move')
someday	('someday',)
theyll	('theyll',)
perceiv	('perceive', 'perceived')
act	('act', 'acting', 'acts')
worker	('worker', 'workers')
road	('road',)
dashboard	('dashboard',)
split-	('split-',)
decis	('decisions', 'decision')
job	('job', 'jobs')
enorm	('enormous',)
had	('had',)
excel	('excellent', 'excellence', 'excel')
full-year	('full-year',)
91	('91',)
ago	('ago',)
123	('123',)
$399	('$399',)
dure	('during',)
prioriti	('priority', 'priorities')
expans	('expansion',)
serv	('serve', 'serves', 'served', 'serving')
truck	('trucks', 'truck', 'trucking')
taxi	('taxis',)
entri	('entry',)
past	('past',)
gpu-	('gpu-',)
sdk	('sdks', 'sdk')
kit	('kits', 'kit')
captur	('capture', 'captured')
expertli	('expertly',)
craft	('crafted', 'craft')
quantum	('quantum',)
cybersecur	('cybersecurity',)
while	('while',)
still	('still',)
few	('few',)
away	('away',)
combinatori	('combinatorial',)
heart	('heart',)
soul	('soul',)
scientif	('scientific',)
autom	('automated', 'automating', 'automation', 'automates', 'automate')
fleet	('fleets', 'fleet')
tensorflow	('tensorflow',)
pytorch	('pytorch',)
spectrum	('spectrum',)
dear	('dear',)
nvidian	('nvidians',)
61%	('61%',)
64%	('64%',)
+260	('+260',)
bp	('bps',)
+123%	('+123%',)
+61%	('+61%',)
$25	('$25',)
$30	('$30',)
73	('73',)
weve	('weve',)
dimens	('dimension',)
direct	('direction', 'direct', 'directed', 'directions', 'directive')
been	('been',)
worth	('worth',)
largest-ev	('largest-ever',)
confer	('conference', 'confers', 'conferences', 'confer')
rollout	('rollout',)
date	('date', 'dated', 'dates')
hopper-architecture-bas	('hopper-architecture-based',)
arriv	('arrived', 'arrival')
unbeliev	('unbelievable',)
order	('order', 'orders', 'ordering')
magnitud	('magnitude',)
ampere-bas	('ampere-based',)
introduc	('introduces', 'introduced', 'introduce')
breakthrough	('breakthrough',)
confidenti	('confidential', 'confidentially', 'confidentiality')
dynam	('dynamic', 'dynamics')
high-spe	('high-speed',)
one-terabyte-per-second	('one-terabyte-per-second',)
news	('news',)
gbp	('gbps',)
readi	('ready', 'readiness')
450	('450',)
reinvent	('reinvents', 'reinvented', 'reinventing', 'reinvent')
blur	('blurring', 'blurred')
real	('real',)
repeatedli	('repeatedly',)
shade	('shading',)
synthesi	('synthesis',)
warp	('warp',)
pull	('pulled', 'pull')
photoshop	('photoshop',)
walkthrough	('walkthroughs',)
showroom	('showrooms',)
possibl	('possible', 'possibility')
between	('between',)
realiti	('reality',)
therefor	('therefore',)
increasingli	('increasingly',)
pattern	('patterns', 'pattern')
relationship	('relationships', 'relationship')
previous	('previously',)
imposs	('impossible',)
spread	('spreading', 'spread')
raw	('raw',)
appli	('applying', 'applied', 'applies', 'apply')
hand	('hands', 'hand')
deck	('deck',)
huge	('huge',)
chapter	('chapter',)
hone	('hone',)
lay	('laying',)
brick	('brick',)
onc	('once',)
prototyp	('prototype',)
demonstr	('demonstrate', 'demonstrated', 'demonstrations')
improv	('improved', 'improve', 'improves', 'improvement', 'improving', 'improvements')
plant	('plants', 'plant')
mainten	('maintenance',)
util	('utility', 'utilize', 'utilization', 'utilized', 'utilizing')
interplay	('interplay',)
cell	('cells', 'cell')
sustain	('sustainability', 'sustained', 'sustainable')
solut	('solutions', 'solution')
download	('downloaded',)
150	('150',)
individu	('individual', 'individuals')
evalu	('evaluated', 'evaluating', 'evaluates', 'evaluate', 'evaluations', 'evaluation')
add	('adds', 'add')
ten	('tens', 'ten')
roboticist	('roboticists',)
festo	('festo',)
recognit	('recognition',)
suggest	('suggest', 'suggestion')
song	('song',)
dawn	('dawning', 'dawn')
shelv	('shelves',)
instrument	('instruments', 'instrument', 'instrumentation', 'instrumental')
procedur	('procedures', 'procedural')
insid	('inside', 'insider')
ride	('riding',)
along	('along',)
navig	('navigation',)
fulfil	('fulfillment', 'fulfill', 'fulfilling')
clean	('cleaning',)
last-mil	('last-mile',)
holoscan	('holoscan',)
ai-pow	('ai-powered',)
medical-grad	('medical-grade',)
surgic	('surgical',)
upcom	('upcoming',)
inflect	('inflection',)
multibillion-dollar	('multibillion-dollar',)
mercedes-benz	('mercedes-benzs', 'mercedes-benz')
battl	('battle',)
live	('living', 'live', 'lives')
field	('field', 'fields')
democrat	('democratized',)
door	('door',)
grandest	('grandest',)
multi-phys	('multi-physics',)
atmospher	('atmosphere', 'atmospheric')
sea	('sea',)
ice	('ice',)
cap	('caps', 'capped', 'cap')
suffici	('sufficiently', 'sufficient')
high	('high',)
resolut	('resolution', 'resolutions')
action	('actions', 'action')
extrem	('extreme', 'extremely')
weather	('weather',)
implic	('implications',)
earli	('early',)
evid	('evidence',)
succeed	('succeed',)
berkeley	('berkeley',)
caltech	('caltech',)
michigan	('michigan',)
purdu	('purdue',)
rice	('rice',)
forecast	('forecasting', 'forecasted', 'forecast', 'forecasts')
fourcastnet	('fourcastnet',)
hurrican	('hurricanes',)
river	('rivers',)
rain	('rain',)
000x	('000x',)
took	('took',)
numer	('numerical', 'numerous', 'numerator')
hope	('hope',)
mitig	('mitigation', 'mitigates', 'mitigate', 'mitigating')
adapt	('adaptation', 'adaption', 'adapter', 'adapt', 'adapters')
brightest	('brightest',)
mind	('minds', 'mind')
threat	('threats', 'threat')
fantast	('fantastic',)
noth	('nothing',)
me	('me',)
prouder	('prouder',)
want	('want',)
so	('so',)
true	('true',)
honor	('honor',)
rank	('ranked', 'ranking')
glassdoor	('glassdoors',)
list	('list', 'listed', 'listing', 'lists')
u	('u',)
employe	('employees', 'employee')
alon	('alone',)
i	('i',)
am	('am',)
grate	('grateful',)
commun	('communities', 'communicate', 'communications', 'community', 'communication', 'communicating', 'communicates', 'communicated')
join	('joined', 'joining')
$22	('$22',)
charit	('charitable',)
area	('areas', 'area')
enter	('enter', 'enters', 'entered')
momentum	('momentum',)
substanti	('substantial', 'substantially')
stride	('strides',)
diversifi	('diversifying',)
never	('never',)
histori	('history', 'histories')
thank	('thank',)
amaz	('amazing',)
excit	('exciting', 'excited')
lie	('lie',)
seek	('seek', 'seeking', 'seeks')
ceo	('ceo', 'ceos')
founder	('founder', 'founders')
april	('april',)
abil	('abilities', 'ability')
nvdia	('nvdia',)
detail	('detailed', 'details', 'detail')
exchang	('exchange', 'exchanges', 'exchanged')
commiss	('commission',)
speak	('speak',)
onli	('only',)
hereof	('hereof',)
stockhold	('stockholders', 'stockholder')
thursday	('thursday',)
june	('june',)
m	('m',)
pacif	('pacific',)
daylight	('daylight',)
locat	('location', 'locate', 'locations')
www	('www',)
virtualshareholdermeet	('virtualshareholdermeeting',)
com	('com',)
nvda2022	('nvda2022',)
elect	('election', 'elected', 'elections', 'elect', 'electing', 'elects')
thirteen	('thirteen',)
nomin	('nominated', 'nomination', 'nominating', 'nominations', 'nominal', 'nominate')
advisori	('advisory',)
approv	('approval', 'approve', 'approved', 'approving', 'approves', 'approvals')
ratif	('ratification',)
select	('selection', 'select', 'selections', 'selects', 'selected')
pricewaterhousecoop	('pricewaterhousecoopers',)
llp	('llp', 'llps')
regist	('registered', 'register')
account	('accounting', 'accounts', 'account', 'accountability', 'accountants', 'accountant', 'accounted')
firm	('firm', 'firms')
amend	('amendment', 'amended', 'amendments', 'amend')
restat	('restated', 'restatement', 'restate', 'restatements')
certif	('certificate', 'certification', 'certifications', 'certificates')
incorpor	('incorporation', 'incorporated', 'incorporate', 'incorporates', 'incorporating')
common	('common',)
2007	('2007',)
equiti	('equity',)
incent	('incentive', 'incentives')
properli	('properly',)
brought	('brought',)
attend	('attend', 'attendance', 'attending', 'attended')
vote	('vote', 'voting', 'votes', 'voted')
close	('close', 'closing', 'closely', 'closed')
entitl	('entitled',)
electron	('electronically', 'electronic', 'electronics')
valid	('valid', 'validity', 'validating', 'validate', 'validated')
purpos	('purpose', 'purposes')
shareholdermeeting@nvidia	('shareholdermeeting@nvidia',)
admiss	('admission',)
particip	('participate', 'participation', 'participants', 'participant', 'participated')
control	('control', 'controls')
print	('printed', 'print')
pre-meet	('pre-meeting',)
forum	('forum', 'forums')
establish	('established', 'establishes', 'establish', 'establishing')
proxyvot	('proxyvote',)
submit	('submit', 'submitted', 'submits', 'submitting')
veri	('very',)
altern	('alternative', 'alternatively', 'alternatives')
telephon	('telephone',)
receiv	('receive', 'received', 'receives', 'receiving', 'receivable', 'receivables')
paper	('paper', 'papering')
mail	('mail', 'mailing')
regard	('regarding', 'regard', 'regarded')
timothi	('timothy',)
teter	('teter', 'teters')
secretari	('secretary',)
2788	('2788',)
san	('san',)
toma	('tomas',)
expressway	('expressway',)
california	('california', 'californias')
95051	('95051',)
tabl	('table', 'tables')
page	('page',)
definit	('definitions', 'definition', 'definitive')
propos	('proposal', 'proposals', 'proposed')
nomine	('nominees', 'nominee')
24	('24',)
member	('members', 'member')
leadership	('leadership',)
structur	('structure', 'structural', 'structured', 'structures')
role	('role', 'roles')
oversight	('oversight',)
polici	('policies', 'policy')
committe	('committees', 'committee')
social	('social', 'socially')
person	('persons', 'person', 'personal')
ownership	('ownership',)
benefici	('beneficial', 'beneficially')
owner	('owners', 'owner')
grant	('grants', 'grant', 'granted', 'granting')
plan-bas	('plan-based',)
award	('awards', 'award', 'awarded')
outstand	('outstanding',)
january\xa030	('january\\xa030',)
54	('54',)
option	('option', 'options')
exercis	('exercises', 'exercise', 'exercisable', 'exercisability', 'exercised', 'exercising')
vest	('vested', 'vest', 'vesting', 'vests')
employ	('employment', 'employed', 'employ', 'employer')
change-in-control	('change-in-control',)
arrang	('arrangements', 'arrangement')
potenti	('potential', 'potentially')
pay	('pay', 'paying')
ratio	('ratio', 'ratios')
interlock	('interlocks',)
fee	('fees', 'fee')
bill	('billed', 'bills', 'billing')
audit	('audit', 'auditing', 'audited', 'audits')
51	('51',)
77	('77',)
delinqu	('delinquent',)
section	('section', 'sections')
a-1	('a-1',)
b-1	('b-1',)
mean	('meaning', 'means', 'mean')
litig	('litigation', 'litigating')
reform	('reform', 'reforms')
1995	('1995',)
assumpt	('assumptions', 'assumption')
case	('cases', 'case')
identifi	('identify', 'identified', 'identifies', 'identifying')
term	('terms', 'term')
would	('would',)
express	('expressions', 'expression', 'expressed', 'express')
varieti	('variety',)
significantli	('significantly',)
espp	('espp',)
ac	('ac', 'acs')
asc	('asc',)
718	('718',)
fasb	('fasb',)
codif	('codification',)
topic	('topic', 'topics')
necessari	('necessary',)
variabl	('variable', 'variability')
sy	('sy',)
psu	('psus', 'psu')
elig	('eligible', 'eligibility')
cc	('cc', 'ccs')
cd&a	('cd&a',)
chief	('chief',)
offic	('officer', 'officers', 'office', 'offices')
cfo	('cfo',)
charter	('charter', 'charters')
delawar	('delaware',)
identif	('identification',)
csr	('csr',)
esg	('esg',)
1934	('1934',)
20__	('20__',)
sunday	('sunday',)
march	('march',)
principl	('principles', 'principle')
1986	('1986',)
my	('my',)
multi-year	('multi-year',)
three-year	('three-year',)
nasdaq	('nasdaq', 'nasdaqs')
llc	('llc',)
ncgc	('ncgc',)
neo	('neos', 'neo')
name	('named', 'name', 'names')
highli	('highly',)
respect	('respective', 'respectively', 'respected', 'respect', 'respects')
stock-	('stock-',)
nyse	('nyse',)
york	('york',)
pac	('pacs',)
polit	('political', 'politics')
pwc	('pwc', 'pwcs')
rsu	('rsu', 'rsus')
restrict	('restricted', 'restrictions', 'restrict', 'restricting', 'restricts')
s&p	('s&p',)
poor	('poors',)
composit	('composite', 'composition')
index	('index',)
162	('162',)
1933	('1933',)
stretch	('stretch',)
maximum	('maximum',)
single-year	('single-year',)
threshold	('threshold', 'thresholds')
minimum	('minimum',)
tsr	('tsr', 'tsrs')
record-break	('record-breaking',)
260	('260',)
higher-end	('higher-end',)
against	('against',)
backdrop	('backdrop',)
disrupt	('disruptions', 'disruptive', 'disrupt', 'disruption', 'disrupted')
strength	('strength',)
leverag	('leverage', 'leveraging', 'leveraged', 'leverages')
122%	('122%',)
123%	('123%',)
125%	('125%',)
58%	('58%',)
natur	('natural', 'nature')
1-year	('1-year',)
3-year	('3-year',)
5-year	('5-year',)
period	('periods', 'period', 'periodically', 'periodic')
76%	('76%',)
474%	('474%',)
728%	('728%',)
repres	('represents', 'representing', 'represented', 'represent', 'representatives', 'representative')
appreci	('appreciation',)
reinvest	('reinvested', 'reinvestment', 'reinvest')
$228	('$228',)
trade	('trading', 'traded', 'trade')
elsewher	('elsewhere',)
consid	('consider', 'considering', 'considers')
read	('read',)
care	('carefully', 'care')
urg	('urges',)
abstent	('abstentions',)
broker	('broker', 'brokers')
non-vot	('non-votes', 'non-vote')
none	('none',)
n	('n',)
follow	('following', 'follow', 'follows', 'followed')
age	('age', 'ages')
sinc	('since',)
expert*	('expert*',)
membership	('membership', 'memberships')
robert	('robert',)
k	('k',)
burgess	('burgess',)
2011	('2011',)
\xfc	('\\xfc',)
tench	('tench',)
cox	('coxe',)
1993	('1993',)
o	('o',)
dabiri	('dabiri',)
persi	('persis',)
drell	('drell',)
jen-hsun	('jen-hsun',)
hudson	('hudson',)
chair	('chair', 'chairs')
harvey	('harvey',)
jone	('jones',)
michael	('michael',)
mccafferi	('mccaffery',)
stephen	('stephen', 'stephens')
neal	('neal', 'neals')
mark	('mark', 'marking', 'marked')
l	('l',)
perri	('perry',)
2005	('2005',)
brook	('brooke',)
seawel	('seawell',)
74	('74',)
1997	('1997',)
aarti	('aarti',)
shah	('shah',)
steven	('stevens',)
2008	('2008',)
**	('**',)
*	('*',)
qualifi	('qualifying', 'qualified', 'qualifies', 'qualify')
until	('until',)
2006	('2006',)
demograph	('demographics', 'demographic')
exhibit	('exhibit', 'exhibits')
compet	('competencies', 'compete', 'competing')
background	('backgrounds', 'background')
viewpoint	('viewpoints',)
perspect	('perspectives', 'perspective')
institut	('institutional', 'institute', 'institutions', 'instituted', 'institution')
longer-serv	('longer-serving',)
idea	('ideas',)
appoint	('appointment', 'appointed', 'appoints', 'appoint')
attribut	('attributes', 'attributable', 'attribution', 'attributed')
possess	('possess', 'possessing', 'possessed', 'possession')
senior	('senior',)
brand	('brand', 'branding', 'brands')
regulatori	('regulatory',)
interest	('interests', 'interest')
issu	('issues', 'issue', 'issued', 'issuing')
practic	('practices', 'practice', 'practicable', 'practical')
well-structur	('well-structured',)
holder	('holders', 'holder')
aggreg	('aggregate', 'aggregated')
32%	('32%',)
insight	('insights', 'insight')
view	('views', 'viewed', 'view')
inclus	('inclusion', 'inclusive', 'inclusions')
\xa0	('\\xa0',)
declassifi	('declassified',)
covid-19	('covid-19', 'covid-19s')
frequent	('frequently',)
session	('sessions', 'session')
self-assess	('self-assessments',)
outreach	('outreach',)
guidelin	('guidelines',)
ask	('asking', 'ask')
cast	('cast', 'casting')
non-bind	('non-binding',)
say-on-pay	('say-on-pay',)
attract	('attract', 'attracting', 'attracts', 'attractive', 'attracted')
retain	('retain', 'retaining', 'retained', 'retainer', 'retains')
high-calib	('high-caliber',)
align	('aligning', 'align', 'aligned', 'alignment', 'aligns')
simplic	('simplicity',)
transpar	('transparency',)
element	('elements', 'element')
heavili	('heavily',)
weight	('weighted', 'weighting', 'weight')
toward	('toward', 'towards')
performance-bas	('performance-based',)
at-risk	('at-risk',)
pre-establish	('pre-established',)
200%	('200%',)
150%	('150%',)
95%	('95%',)
paid	('paid',)
feedback	('feedback',)
conclud	('concluded', 'concludes', 'concluding', 'conclude')
same	('same',)
ii	('ii',)
strengthen	('strengthen', 'strengthening', 'strengthens', 'strengthened')
link	('link', 'links', 'linking')
portion	('portion', 'portions')
tie	('tied',)
success	('success', 'successful', 'successfully', 'succession')
show	('shows',)
payout	('payout', 'payouts')
%	('%',)
25th	('25th',)
percentil	('percentile', 'percentiles')
25%	('25%',)
50th	('50th',)
$23	('$23',)
75th	('75th',)
billion*	('billion*',)
626%*	('626%*',)
100th	('100th',)
*see	('*see',)
ratifi	('ratify', 'ratified', 'ratifying')
reconsid	('reconsider',)
nevertheless	('nevertheless',)
912	('912',)
755	('755',)
520	('520',)
issuanc	('issuance', 'issuances')
adequ	('adequate', 'adequately')
split	('splits', 'split')
merger	('mergers', 'merger')
rais	('raising', 'raised')
compon	('component', 'components')
motiv	('motivating', 'motivate', 'motivation')
sound	('sound', 'sounds')
aspect	('aspect', 'aspects')
408	('408',)
486-2000	('486-2000',)
\xa0\xa0____________________________________________________	('\\xa0\\xa0____________________________________________________',)
____________________________________________________	('____________________________________________________',)
amount	('amounts', 'amount')
four-for-on	('four-for-one',)
juli	('july',)
solicit	('solicited', 'soliciting', 'solicit', 'solicits')
behalf	('behalf',)
philosophi	('philosophy', 'philosophies')
format	('format',)
invit	('invites',)
in-person	('in-person',)
focus	('focused', 'focuses')
directli	('directly',)
archiv	('archived',)
webcast	('webcast', 'webcasts')
listen	('listen',)
encount	('encounter', 'encountered')
difficulti	('difficulties', 'difficulty')
check-in	('check-in',)
cours	('course',)
count	('counted', 'count')
later	('later',)
decid	('decide', 'decided', 'deciding')
encourag	('encourage', 'encourages')
stockholder-submit	('stockholder-submitted',)
permit	('permits', 'permitted', 'permit')
pertin	('pertinent',)
fair	('fairness', 'fair')
resourc	('resources', 'resource', 'resourced')
respond	('respond',)
quorum	('quorum',)
either	('either',)
504	('504',)
014	('014',)
351	('351',)
252	('252',)
007	('007',)
176	('176',)
adjourn	('adjourn',)
abstain	('abstain', 'abstaining')
transfer	('transfer', 'transferred', 'transferability', 'transferable', 'transfers', 'transferring')
computershar	('computershare',)
revok	('revoke', 'revoking')
final	('final', 'finally', 'finalization', 'finalized', 'finality')
sign	('signing', 'signed', 'sign')
instruct	('instructions', 'instruction')
send	('send', 'sending')
written	('written',)
attent	('attention',)
email	('email',)
bank	('bank', 'banks')
separ	('separate', 'separation', 'separately')
tell	('tell',)
obtain	('obtain', 'obtaining', 'obtained')
non-routin	('non-routine',)
contest	('contested', 'contests')
howev	('however',)
routin	('routine',)
favor	('favor', 'favorable')
discretionari	('discretionary',)
strongli	('strongly',)
whose	('whose',)
brokerag	('brokerage',)
hi	('his',)
her	('her',)
rule	('rules', 'rule', 'rulings', 'ruling')
nation	('national', 'nations', 'nationals')
inspector	('inspector',)
2-5	('2-5',)
proxyhold	('proxyholder',)
judgment	('judgment', 'judgments')
preliminari	('preliminary',)
sent	('sent',)
request	('requested', 'request', 'requesting', 'requests')
choos	('choose', 'choosing')
icsdeliveri	('icsdelivery',)
nvda	('nvda',)
site	('site', 'sites')
intermediari	('intermediaries', 'intermediary')
satisfi	('satisfy', 'satisfying', 'satisfied')
household	('householding', 'household')
unless	('unless',)
contrari	('contrary',)
modifi	('modify', 'modified')
notifi	('notified', 'notify')
otherwis	('otherwise',)
consent	('consent', 'consents')
receipt	('receipt', 'receipts')
depart	('department', 'departments')
phone	('phone', 'phones')
mackenzi	('mackenzie',)
reimburs	('reimburse', 'reimbursement', 'reimbursements', 'reimbursed')
forward	('forwarding', 'forwarded', 'forward')
decemb	('december',)
compli	('comply', 'complies', 'complied', 'complying')
rule\xa014a-8	('rule\\xa014a-8',)
promulg	('promulgated',)
deadlin	('deadline', 'deadlines')
wish	('wish', 'wishes')
consider	('consideration', 'considerable', 'considerations')
pursuant	('pursuant',)
provis	('provision', 'provisions')
bylaw	('bylaws', 'bylaw')
earlier	('earlier',)
februari	('february',)
advis	('advise', 'advised', 'advising', 'advises', 'advisable', 'adviser', 'advisers')
forego	('foregoing',)
14a-19	('14a-19',)
successor	('successor', 'successors')
one-year	('one-year',)
stand	('stand',)
regul	('regulations', 'regulation', 'regulators', 'regulator')
mr	('mr',)
presid	('president', 'presiding')
unabl	('unable',)
size	('size', 'sizes')
occup	('occupation',)
consult	('consultant', 'consulting', 'consults', 'consultants', 'consultation', 'consult')
centenni	('centennial',)
professor	('professor', 'professors')
aeronaut	('aeronautics',)
mechan	('mechanical', 'mechanics', 'mechanism', 'mechanisms')
provost	('provost',)
stanford	('stanford',)
squar	('square',)
ventur	('ventures', 'venture')
makena	('makena',)
chairman	('chairman',)
emeritu	('emeritus',)
counsel	('counsel',)
cooley	('cooley',)
associ	('associates', 'association', 'associations', 'associate')
s-cube	('s-cubed',)
assess	('assesses', 'assessment', 'assess', 'assessments', 'assessing', 'assessed')
shall	('shall',)
conduct	('conduct', 'conducting', 'conducts', 'conducted')
appropri	('appropriate', 'appropriately', 'appropriateness')
inquiri	('inquiries', 'inquiry')
candid	('candidates',)
due	('due',)
dilig	('diligence',)
\xa0th	('\\xa0the',)
educ	('education', 'educator', 'educational', 'educating', 'educate')
instead	('instead',)
candor	('candor',)
sexual	('sexuality',)
underrepres	('underrepresented',)
academia	('academia',)
willing	('willingness',)
devot	('devote',)
rather	('rather',)
constitu	('constituencies',)
competitor	('competitors', 'competitor')
re-elect	('re-election',)
strive	('strive', 'strives')
tenur	('tenure',)
longer-tenur	('longer-tenured',)
familiar	('familiar', 'familiarity')
overse	('overseeing', 'oversees', 'oversee')
newer	('newer',)
academ	('academic',)
outsid	('outside',)
experienc	('experienced',)
cultur	('culture', 'cultural')
facilit	('facilitate', 'facilitating', 'facilitates')
deeper	('deeper',)
financ	('finances', 'finance', 'financing')
valuabl	('valuable',)
compliance-	('compliance-',)
given	('given',)
guidanc	('guidance',)
complianc	('compliance',)
jurisdict	('jurisdictions', 'jurisdiction', 'jurisdictional')
lawsuit	('lawsuits', 'lawsuit')
government	('governmental',)
critic	('critical',)
organiz	('organizational',)
workforc	('workforce',)
dialogu	('dialogue',)
decision-mak	('decision-making',)
room	('room',)
biographi	('biographies',)
icon	('icon',)
indic	('indicates', 'indicated', 'indices', 'indicate', 'indication', 'indicators', 'indicative')
complementari	('complementary',)
self-	('self-',)
matrix	('matrix',)
ident	('identity', 'identical')
male	('male',)
femal	('female',)
binari	('binary',)
did	('did',)
disclos	('disclose', 'disclosed', 'disclosing')
african	('african',)
american	('american',)
black	('black',)
hispan	('hispanic',)
latinx	('latinx',)
asian	('asian',)
nativ	('native',)
alaskan	('alaskan',)
hawaiian	('hawaiian',)
island	('islander', 'islands')
white	('white',)
lgbtq+	('lgbtq+',)
criteria	('criteria',)
prospect	('prospective',)
submiss	('submissions', 'submission')
previou	('previous',)
five	('five',)
biograph	('biographical',)
represent	('representation', 'representations')
accompani	('accompanied', 'accompanying', 'accompany')
voluntarili	('voluntarily',)
specifi	('specified', 'specify')
particular	('particular',)
rel	('relative', 'relatively')
he	('he',)
she	('she',)
1996	('1996',)
macromedia	('macromedia',)
inc	('inc',)
multimedia	('multimedia',)
acquir	('acquired', 'acquirer', 'acquiring', 'acquire', 'acquires')
1998	('1998',)
1984	('1984',)
1991	('1991',)
sgi	('sgi',)
alia	('alias',)
publicli	('publicly',)
resum	('resumed', 'resume')
imri	('imris',)
therapi	('therapy',)
roger	('rogers',)
bcom	('bcom',)
degre	('degree', 'degrees')
mcmaster	('mcmaster',)
sutter	('sutter',)
hill	('hill',)
1989	('1989',)
sector	('sector',)
1987	('1987',)
mi	('mis',)
mattersight	('mattersight',)
corp	('corp',)
loyalti	('loyalty',)
ba	('ba',)
dartmouth	('dartmouth',)
colleg	('college',)
mba	('mba',)
harvard	('harvard',)
school	('school',)
method	('methods', 'method')
artisan	('artisan',)
recipi	('recipient', 'recipients')
macarthur	('macarthur',)
geniu	('genius',)
alan	('alan',)
t	('t',)
waterman	('waterman',)
presidenti	('presidential',)
career	('career', 'careers')
head	('heads', 'heading')
lab	('lab', 'labs')
intersect	('intersections',)
fluid	('fluid',)
civil	('civil',)
eugen	('eugene',)
teach	('teaching',)
bioengin	('bioengineering',)
bioinspir	('bioinspired',)
wind	('wind',)
faculti	('faculty',)
dean	('dean',)
student	('students', 'student')
dr	('dr',)
fellow	('fellow',)
divis	('division', 'divisions')
biden	('bidens',)
council	('council',)
advisor	('advisors', 'advisor')
pcast	('pcast',)
granholm	('granholms',)
seab	('seab',)
truste	('trustees', 'trustee')
gordon	('gordon',)
betti	('betty',)
academi	('academies', 'academy')
phd	('phd',)
ms	('ms',)
bse	('bse',)
summa	('summa',)
cum	('cum',)
laud	('laude',)
aerospac	('aerospace',)
princeton	('princeton',)
versatil	('versatile',)
proven	('proven',)
vice	('vice',)
slac	('slac',)
laboratori	('laboratory',)
2002	('2002',)
guggenheim	('guggenheim',)
fellowship	('fellowship',)
young	('young',)
investig	('investigator', 'investigation', 'investigations')
ab	('ab', 'abs')
mathemat	('mathematics',)
wellesley	('wellesley',)
accomplish	('accomplished',)
incept	('inception',)
semiconductor	('semiconductor', 'semiconductors')
highest	('highest',)
noyc	('noyce',)
ieee	('ieee',)
medal	('medal',)
morri	('morris',)
exemplari	('exemplary',)
honorari	('honorary',)
doctor	('doctorate',)
taiwan	('taiwans', 'taiwan')
chiao	('chiao',)
tung	('tung',)
oregon	('oregon',)
him	('him',)
best-perform	('best-performing',)
lifetim	('lifetime',)
businessperson	('businessperson',)
lsi	('lsi', 'lsis')
logic	('logic',)
micro	('micro',)
devic	('devices', 'device')
bsee	('bsee',)
msee	('msee',)
taken	('taken',)
compil	('compiled',)
sharp	('sharp',)
footbal	('football',)
leagu	('league',)
2009	('2009',)
parthenon	('parthenon',)
pepsi-cola	('pepsi-cola',)
north	('north',)
beverag	('beverage',)
canada	('canada',)
simultan	('simultaneously',)
foodservic	('foodservice',)
spent	('spent',)
agenc	('agencies', 'agency')
darci	('darcy',)
masiu	('masius',)
benton\xa0&	('benton\\xa0&',)
bowl	('bowles',)
omnicom	('omnicom',)
skincar	('skincare',)
f	('f',)
bistro	('bistro',)
restaur	('restaurant',)
allergan	('allergan',)
biopharmaceut	('biopharmaceutical',)
home	('home',)
2001	('2001',)
amplifi	('amplify', 'amplifying', 'amplifiers', 'amplified')
snack	('snack',)
food	('food',)
english	('english',)
longtim	('longtime',)
interpubl	('interpublic',)
mtg	('mtg', 'mtgs')
2004	('2004',)
entrepreneur	('entrepreneur',)
1981	('1981',)
daisi	('daisy',)
computer-aid	('computer-aided',)
ultim	('ultimately', 'ultimate')
synopsi	('synopsys',)
seven	('seven',)
tensilica	('tensilica',)
embed	('embedded', 'embedding')
cadenc	('cadence',)
tintri	('tintri',)
bs	('bs',)
georgetown	('georgetown',)
massachusett	('massachusetts',)
subsidiari	('subsidiary', 'subsidiaries')
estat	('estate',)
robertson	('robertson',)
francisco-bas	('francisco-based',)
1999	('1999',)
non-profit	('non-profits', 'non-profit')
kb	('kb',)
homebuild	('homebuilding',)
2003	('2003',)
woodrow	('woodrow',)
wilson	('wilson',)
affair	('affairs',)
honour	('honours',)
ma	('ma',)
merton	('merton',)
oxford	('oxford',)
england	('england',)
graduat	('graduate',)
array	('array',)
c3	('c3',)
extens	('extensive', 'extension')
trial	('trial',)
lawyer	('lawyer',)
kirkland	('kirkland',)
elli	('ellis',)
levi	('levi',)
strauss	('strauss',)
co	('co',)
jd	('jd', 'jds')
drawn	('drawn',)
throughout	('throughout',)
entrepreneur-in-	('entrepreneur-in-',)
resid	('residence', 'reside', 'residency', 'residents', 'resides')
rock	('rock',)
aerov	('aerovance',)
1994	('1994',)
gilead	('gilead',)
facil	('facilities', 'facility')
myokardia	('myokardia',)
davi	('davis',)
vari	('varied', 'vary', 'varying')
blood	('blood',)
therapeut	('therapeutics',)
crossov	('crossover',)
netdynam	('netdynamics',)
sun	('sun',)
microsystem	('microsystems',)
glu	('glu',)
mobil	('mobile', 'mobility')
informatica	('informatica',)
tableau	('tableau',)
athlet	('athletic',)
tenabl	('tenable',)
eargo	('eargo',)
22	('22',)
eli	('eli',)
lilli	('lilly', 'lillys')
statistician	('statistician',)
biometr	('biometrics',)
bio-medicin	('bio-medicines',)
northwestern	('northwestern',)
mutual	('mutual',)
nonprofit	('nonprofit',)
indiana	('indiana',)
india	('india',)
shrimad	('shrimad',)
rajchandra	('rajchandra',)
love	('love',)
usa	('usa',)
indianapoli	('indianapolis',)
interfaith	('interfaith',)
cooper	('cooperation',)
bachelor	('bachelors',)
master	('masters',)
statist	('statistics', 'statistically')
riversid	('riverside',)
health	('health',)
sequoia	('sequoia',)
preced	('preceding',)
staff	('staff',)
hugh	('hughes',)
aircraft	('aircraft',)
southern	('southern',)
quantenna	('quantenna',)
wi-fi	('wi-fi',)
high-	('high-',)
divestitur	('divestitures', 'divestiture')
1993-2006	('1993-2006',)
interfer	('interfere',)
exceed	('exceed', 'exceeded', 'exceeding')
entiti	('entitys', 'entity', 'entities')
consolid	('consolidated', 'consolidation', 'consolidations')
messr	('messrs',)
ensur	('ensures',)
voic	('voice',)
chairperson	('chairperson', 'chairpersons')
\xa0perri	('\\xa0perry',)
afford	('affords', 'afford')
primari	('primary',)
agenda	('agendas', 'agenda')
duti	('duties', 'duty')
interf	('interfering',)
regular	('regular',)
qualiti	('quality',)
quantiti	('quantity', 'quantities')
timeli	('timeliness',)
coordin	('coordinating', 'coordination')
moder	('moderating', 'moderate')
liaison	('liaison',)
sensit	('sensitive', 'sensitivity')
deleg	('delegates', 'delegated', 'delegate', 'delegation')
exposur	('exposures', 'exposure')
step	('steps',)
monitor	('monitor', 'monitors', 'monitoring')
anonym	('anonymous', 'anonymously')
tip	('tip',)
prevent	('preventing', 'prevents', 'prevent', 'preventative', 'prevented', 'prevention')
illeg	('illegal',)
improp	('improper',)
liability-cr	('liability-creating',)
artifici	('artificial',)
excess	('excessive', 'excess')
risk-tak	('risk-taking',)
adequaci	('adequacy',)
regularli	('regularly',)
met	('met',)
formal	('formal',)
absent	('absent',)
wherebi	('whereby',)
interview	('interviews', 'interview')
thing	('things', 'thing')
began	('began',)
orient	('orientation',)
administ	('administering', 'administers', 'administered', 'administer')
non-employe	('non-employee',)
salari	('salary',)
defer	('deferred', 'defer')
trust	('trust',)
immedi	('immediate', 'immediately')
unvest	('unvested',)
unexercis	('unexercised', 'unexercisable')
exce	('exceeds',)
hedg	('hedging', 'hedge', 'hedges', 'hedged')
pledg	('pledging', 'pledge')
designe	('designees',)
put	('puts', 'put', 'putative', 'putting')
deriv	('derivative', 'derived', 'derive', 'derivatives')
borrow	('borrow', 'borrowing')
collater	('collateral',)
loan	('loan',)
portfolio	('portfolio', 'portfolios')
diversif	('diversification',)
fund	('funds', 'fund')
interim	('interim',)
incapacit	('incapacitated',)
themselv	('themselves',)
ethic	('ethics', 'ethical')
honesti	('honesty',)
credibl	('credibility',)
reput	('reputation', 'reputational')
depend	('depend', 'depending', 'depends', 'dependent', 'dependency')
clear	('clear',)
waiver	('waiver',)
promptli	('promptly',)
hotlin	('hotline',)
contractor	('contractor', 'contractors')
lodg	('lodge',)
complaint	('complaint', 'complaints')
concern	('concern', 'concerns', 'concerning')
prohibit	('prohibited', 'prohibit', 'prohibitions')
local	('local', 'localization', 'localities')
privaci	('privacy',)
letter	('letters', 'letter')
seriou	('serious',)
uncontest	('uncontested',)
choic	('choice', 'choices')
affirm	('affirmative',)
incumb	('incumbent',)
non-contest	('non-contested',)
tender	('tender', 'tenders', 'tendered', 'tendering')
resign	('resignation',)
reject	('reject',)
rational	('rationale',)
behind	('behind',)
deem	('deemed', 'deem', 'deems')
withhold	('withhold', 'withholding')
plural	('plurality',)
presenc	('presence',)
explor	('explored', 'exploration', 'explore')
roadmap	('roadmap',)
assign	('assignments', 'assign', 'assigned', 'assignment', 'assigning')
rotat	('rotations', 'rotated', 'rotates')
usag	('usage',)
treasuri	('treasury',)
retent	('retention', 'retentive')
permiss	('permissible',)
non-audit	('non-audit',)
press	('press',)
substanc	('substance',)
analyst	('analysts',)
form\xa010-k	('form\\xa010-k',)
treatment	('treatment',)
well-b	('well-being',)
disclosur	('disclosure', 'disclosures')
recruit	('recruiting', 'recruit', 'recruitment', 'recruits')
violat	('violations', 'violate', 'violation', 'violated', 'violating')
29	('29',)
1a	('1a',)
lifecycl	('lifecycle', 'lifecycles')
expenditur	('expenditures', 'expenditure')
enough	('enough',)
match	('match', 'matches')
high-perform	('high-performance',)
inher	('inherently', 'inherent')
watt	('watt',)
absolut	('absolute',)
40x	('40x',)
evidenc	('evidenced', 'evidencing')
green500	('green500',)
novemb	('november',)
ultra-high-resolut	('ultra-high-resolution',)
urgenc	('urgency',)
473	('473',)
countri	('countries', 'country')
242	('242',)
231	('231',)
non-techn	('non-technical',)
differenti	('differentiated', 'differential')
hire	('hiring', 'hires', 'hired', 'hire')
affili	('affiliations', 'affiliates', 'affiliate', 'affiliated')
39%	('39%',)
referr	('referrals',)
on-the-job	('on-the-job',)
coach	('coaching',)
ongo	('ongoing',)
on-demand	('on-demand',)
workshop	('workshops',)
panel	('panel',)
speaker	('speaker',)
curat	('curate',)
constantli	('constantly',)
expos	('exposed', 'expose', 'exposes')
tuition	('tuition',)
subsid	('subsidize', 'subside')
development	('developmental',)
pursu	('pursuing', 'pursue')
mentor	('mentoring',)
women	('women',)
widespread	('widespread',)
puls	('pulse',)
survey	('surveys', 'survey')
box	('box',)
third-	('third-',)
priorit	('prioritize', 'prioritizing')
always-on	('always-on',)
thought	('thoughts', 'thought', 'thoughtful')
third-parti	('third-party',)
turnov	('turnover',)
reward	('rewards', 'reward')
unavail	('unavailable',)
comprehens	('comprehensive',)
401	('401',)
statutori	('statutory',)
pension	('pension',)
flexibl	('flexible', 'flexibility')
hour	('hours',)
mental	('mental',)
stress	('stress',)
time-manag	('time-management',)
tailor	('tailored',)
militari	('military',)
birth	('birth',)
parent	('parents', 'parent')
regardless	('regardless',)
veteran	('veteran',)
statu	('status',)
latino	('latino',)
deepen	('deepened',)
minority-serv	('minority-serving',)
peer	('peers', 'peer')
foster	('foster', 'fostering')
progress	('progress', 'progressive')
visibl	('visibility',)
19%	('19%',)
declar	('declared', 'declaration')
pandem	('pandemic', 'pandemics')
protocol	('protocols',)
keep	('keep',)
safe	('safe',)
distanc	('distancing',)
clearli	('clearly',)
adher	('adhering', 'adheres')
coverag	('coverage',)
including-covid-19	('including-covid-19',)
vaccin	('vaccine',)
remot	('remotely', 'remote')
company-wid	('company-wide',)
rest	('rest',)
recharg	('recharge',)
advocaci	('advocacy',)
policymak	('policymakers',)
incur	('incur', 'incurred', 'incurring')
advoc	('advocate',)
kind	('kind',)
money	('money',)
lobbyist	('lobbyists',)
broader	('broader',)
lobbi	('lobbying',)
feder	('federal',)
http	('https', 'http')
governance-docu	('governance-documents',)
exequ	('exequity', 'exequitys')
$340	('$340',)
median	('median',)
$85	('$85',)
$255	('$255',)
divid	('divided', 'divide')
30-calendar	('30-calendar',)
trail	('trailing',)
averag	('average', 'averaging')
suscept	('susceptible',)
volatil	('volatility', 'volatile')
correl	('correlate',)
wednesday	('wednesday',)
death	('death',)
beneficiari	('beneficiary', 'beneficiaries')
sooner	('sooner',)
409a	('409a',)
cessat	('cessation',)
assum	('assume', 'assumed', 'assumes', 'assuming')
82	('82',)
301	('301',)
381	('381',)
383	('383',)
881	('881',)
$75	('$75',)
shown	('shown',)
column	('column', 'columns')
note	('note', 'noted', 'notes')
$175	('$175',)
860	('860',)
808	('808',)
996	('996',)
032	('032',)
736	('736',)
232	('232',)
avoid	('avoid',)
conflict	('conflicts', 'conflicting', 'conflict')
appear	('appearance', 'appearing', 'appear', 'appears')
daughter	('daughter',)
$160	('$160',)
indemn	('indemnity', 'indemnities')
agreement	('agreements', 'agreement')
indemnifi	('indemnify',)
extent	('extent',)
therein	('therein',)
damag	('damages', 'damage', 'damaged')
fine	('fines',)
proceed	('proceedings', 'proceed')
fullest	('fullest',)
13g	('13g',)
503	('503',)
959	('959',)
006	('006',)
issuabl	('issuable',)
84	('84',)
421	('421',)
722	('722',)
87	('87',)
521	('521',)
colett	('colette',)
kress	('kress',)
447	('447',)
471	('471',)
ajay	('ajay',)
puri	('puri',)
314	('314',)
654	('654',)
debora	('debora',)
shoquist	('shoquist',)
283	('283',)
840	('840',)
170	('170',)
459	('459',)
140	('140',)
384	('384',)
664	('664',)
385	('385',)
524	('524',)
812	('812',)
672	('672',)
980	('980',)
41	('41',)
101	('101',)
148	('148',)
989	('989',)
444	('444',)
016	('016',)
008	('008',)
868	('868',)
257	('257',)
943	('943',)
258	('258',)
98	('98',)
105	('105',)
106	('106',)
880	('880',)
243	('243',)
985	('985',)
04%	('04%',)
vanguard	('vanguard',)
196	('196',)
015	('015',)
550	('550',)
83%	('83%',)
blackrock	('blackrock',)
177	('177',)
858	('858',)
484	('484',)
fmr	('fmr',)
158	('158',)
039	('039',)
922	('922',)
31%	('31%',)
\xa061	('\\xa061',)
347	('347',)
714	('714',)
lori	('lori',)
co-truste	('co-trustees', 'co-trustee')
d	('d',)
may\xa01	('may\\xa01',)
\xa04	('\\xa04',)
948	('948',)
956	('956',)
j	('j',)
228	('228',)
irrevoc	('irrevocable',)
wife	('wife',)
050	('050',)
annuiti	('annuity',)
lynn	('lynn',)
remaind	('remainder',)
virtu	('virtue',)
referenc	('referenced',)
dispos	('dispose', 'disposes', 'disposed')
disposit	('disposition', 'dispositive', 'dispositions')
son	('son',)
133	('133',)
revoc	('revocable',)
dtd	('dtd',)
children	('childrens',)
06	('06',)
\xa0puri	('\\xa0puri',)
pecuniari	('pecuniary',)
210	('210',)
120	('120',)
149	('149',)
horn	('horne',)
685	('685',)
248	('248',)
retir	('retirement', 'retired')
\xa0cox	('\\xa0coxe',)
697	('697',)
136	('136',)
contractu	('contractual',)
866	('866',)
h	('h',)
\xa0jon	('\\xa0jones',)
984	('984',)
07	('07',)
900	('900',)
rhyu	('rhyu',)
05	('05',)
160	('160',)
perry\xa0&	('perry\\xa0&',)
pena	('pena',)
rosemary\xa0&	('rosemary\\xa0&',)
\xa0seawel	('\\xa0seawell',)
988	('988',)
343	('343',)
3rd	('3rd',)
millennium	('millennium',)
\xa0steven	('\\xa0stevens',)
640	('640',)
envi	('envy',)
february\xa09	('february\\xa09',)
february\xa010	('february\\xa010',)
december\xa031	('december\\xa031',)
185	('185',)
753	('753',)
501	('501',)
boulevard	('boulevard',)
malvern	('malvern',)
pennsylvania	('pennsylvania',)
19355	('19355',)
153	('153',)
411	('411',)
587	('587',)
east	('east',)
52nd	('52nd',)
10055	('10055',)
245	('245',)
summer	('summer',)
boston	('boston',)
02210	('02210',)
section\xa0	('section\\xa0',)
14a	('14a',)
commonli	('commonly',)
narr	('narrative',)
bind	('binding',)
accordingli	('accordingly',)
r	('r',)
esolv	('esolved',)
item\xa0402	('item\\xa0402',)
s-k	('s-k',)
herebi	('hereby',)
evp	('evp',)
datacent	('datacenter',)
year-over-year	('year-over-year',)
96%	('96%',)
fourth	('fourth',)
consecut	('consecutive',)
one-of-a-kind	('one-of-a-kind',)
emphas	('emphasize', 'emphasized')
simpl	('simple',)
dont	('dont',)
distinct	('distinct',)
minim	('minimize', 'minimal')
meaning	('meaningful', 'meaningfully')
clawback	('clawback',)
x	('x',)
automat	('automatic', 'automatically')
change-in-	('change-in-',)
supplement	('supplemental', 'supplements')
perquisit	('perquisites',)
gross-up	('gross-ups',)
repric	('reprice', 'repricing')
unearn	('unearned',)
cycl	('cycle', 'cycles')
nov	('nov',)
dec	('dec',)
mar	('mar',)
apr	('apr',)
certifi	('certified', 'certifies', 'certify')
gather	('gathered',)
radford	('radford',)
advic	('advice',)
iii	('iii',)
v	('v',)
roughli	('roughly',)
5-3	('5-3',)
cisco	('cisco',)
intuit	('intuit',)
qualcomm	('qualcomm',)
tesla	('tesla',)
ibm	('ibm',)
salesforc	('salesforce',)
texa	('texas',)
broadcom	('broadcom',)
paypal	('paypal',)
sap	('sap',)
chose	('chose',)
smaller	('smaller',)
larger	('larger',)
12-month	('12-month',)
$165	('$165',)
$331	('$331',)
situat	('situated', 'situations')
similarli	('similarly',)
programs*	('programs*',)
fix	('fixed', 'fix', 'fixing')
retroact	('retroactively',)
semi-monthli	('semi-monthly',)
payrol	('payroll',)
anniversari	('anniversary',)
3-	('3-',)
timefram	('timeframe', 'timeframes')
day-to-day	('day-to-day',)
realiz	('realized', 'realize', 'realizable', 'realizing', 'realization')
44	('44',)
insur	('insurance', 'insurers')
again	('again',)
formula	('formula',)
context	('context',)
above-market	('above-market',)
pertain	('pertaining', 'pertain')
closer	('closer',)
grown	('grown',)
emphasi	('emphasis',)
predetermin	('predetermined',)
performance-	('performance-',)
tightli	('tightly',)
longer-term	('longer-term',)
conting	('contingent', 'contingency', 'contingencies')
time-vest	('time-vesting',)
felt	('felt',)
intellectu	('intellectual',)
underli	('underlying',)
cancel	('cancelled', 'canceling', 'cancellation', 'cancel', 'canceled', 'cancellable')
46	('46',)
macroeconom	('macroeconomic',)
straight-lin	('straight-line',)
interpol	('interpolation',)
daili	('daily',)
one-day	('one-day',)
fluctuat	('fluctuations', 'fluctuated', 'fluctuate')
uncertain	('uncertain',)
attain	('attainable', 'attained', 'attainment')
deceler	('decelerated',)
budget	('budgeted', 'budgets')
becam	('became',)
999	('999',)
572	('572',)
786	('786',)
060	('060',)
$600	('$600',)
799	('799',)
355	('355',)
29%	('29%',)
839	('839',)
67	('67',)
439	('439',)
739	('739',)
080	('080',)
519	('519',)
628	('628',)
652	('652',)
650	('650',)
399	('399',)
021	('021',)
619	('619',)
547	('547',)
712	('712',)
419	('419',)
751	('751',)
940	('940',)
359	('359',)
850	('850',)
$500	('$500',)
899	('899',)
338	('338',)
17%	('17%',)
893	('893',)
580	('580',)
938	('938',)
416	('416',)
328	('328',)
14%	('14%',)
77%	('77%',)
risk-bas	('risk-based',)
aris	('arises', 'arise', 'arising')
company-incur	('company-incurred',)
dental	('dental',)
accident	('accidental',)
disabl	('disability', 'disabled')
deferr	('deferral', 'deferrals')
executive-level	('executive-level',)
occas	('occasion',)
nonpubl	('nonpublic',)
non-publ	('non-public',)
manner	('manner',)
intent	('intentionally', 'intention', 'intents')
49	('49',)
recoveri	('recovery',)
correct	('correct', 'corrective', 'corrections', 'correction')
error	('error', 'errors')
noncompli	('noncompliance',)
payabl	('payable',)
origin	('original', 'originally')
overpay	('overpayment',)
disgorg	('disgorge', 'disgorgement')
after-tax	('after-tax',)
repay	('repay', 'repayment', 'repayments')
recoup	('recoup', 'recoupment')
partial	('partial', 'partially')
open-market	('open-market',)
dodd-frank	('dodd-frank',)
taxabl	('taxable',)
non-deduct	('non-deductible',)
relief	('relief',)
cut	('cuts',)
deduct	('deductible', 'deduction', 'deductions', 'deductibility', 'deductibles', 'deducting', 'deduct')
exempt	('exempt', 'exemption', 'exemptions')
modif	('modifications', 'modification')
consequ	('consequences',)
non-compli	('non-compliance', 'non-compliant')
share-bas	('share-based',)
ascertain	('ascertain',)
find	('findings',)
guard	('guard',)
long-	('long-',)
recov	('recover',)
misconduct	('misconduct',)
enforc	('enforce', 'enforced', 'enforcement', 'enforceable')
no-hedg	('no-hedging',)
no-pledg	('no-pledging',)
insul	('insulating',)
52-week	('52-week',)
53-week	('53-week',)
non-equ	('non-equity',)
216	('216',)
660	('660',)
81	('81',)
038	('038',)
737	('737',)
661	('661',)
017	('017',)
279	('279',)
780	('780',)
266	('266',)
316	('316',)
514	('514',)
676	('676',)
805	('805',)
402	('402',)
492	('492',)
896	('896',)
595	('595',)
269	('269',)
020	('020',)
312	('312',)
775	('775',)
927	('927',)
915	('915',)
620	('620',)
731	('731',)
121	('121',)
863	('863',)
307	('307',)
219	('219',)
667	('667',)
122	('122',)
432	('432',)
946	('946',)
406	('406',)
892	('892',)
819	('819',)
493	('493',)
172	('172',)
966	('966',)
487	('487',)
052	('052',)
388	('388',)
689	('689',)
410	('410',)
921	('921',)
944	('944',)
151	('151',)
856	('856',)
705	('705',)
784	('784',)
483	('483',)
478	('478',)
851	('851',)
864	('864',)
752	('752',)
904	('904',)
581	('581',)
109	('109',)
237	('237',)
847	('847',)
037	('037',)
200	('200',)
183	('183',)
056	('056',)
457	('457',)
771	('771',)
783	('783',)
191	('191',)
157	('157',)
173	('173',)
957	('957',)
probabl	('probable',)
outcom	('outcome', 'outcomes')
074	('074',)
093	('093',)
536	('536',)
968	('968',)
415	('415',)
047	('047',)
816	('816',)
559	('559',)
942	('942',)
031	('031',)
872	('872',)
$821	('$821',)
923	('923',)
810	('810',)
497	('497',)
035	('035',)
748	('748',)
639	('639',)
621	('621',)
$977	('$977',)
104	('104',)
546	('546',)
$901	('$901',)
$596	('$596',)
540	('540',)
734	('734',)
793	('793',)
$479	('$479',)
310	('310',)
882	('882',)
578	('578',)
815	('815',)
610	('610',)
$368	('$368',)
371	('371',)
imput	('imputed',)
$56	('$56',)
588	('588',)
308	('308',)
642	('642',)
902	('902',)
pre-	('pre-',)
service-bas	('service-based',)
#	('#',)
of\xa0stock	('of\\xa0stock',)
jen-	('jen-',)
hsun	('hsun',)
\xa0\xa0	('\\xa0\\xa0',)
264	('264',)
508	('508',)
395	('395',)
207	('207',)
772	('772',)
523	('523',)
908	('908',)
905	('905',)
971	('971',)
094	('094',)
112	('112',)
754	('754',)
325	('325',)
288	('288',)
515	('515',)
936	('936',)
604	('604',)
832	('832',)
962	('962',)
556	('556',)
125	('125',)
abl	('able',)
options\xa0	('options\\xa0',)
expir	('expiration', 'expires', 'expire', 'expired', 'expiring')
number\xa0of	('number\\xa0of',)
units\xa0of\xa0stock	('units\\xa0of\\xa0stock',)
not\xa0vested\xa0	('not\\xa0vested\\xa0',)
market\xa0valu	('market\\xa0value',)
\xa0of	('\\xa0of',)
market\xa0value\xa0of	('market\\xa0value\\xa0of',)
292	('292',)
340	('340',)
615	('615',)
4275	('4275',)
155	('155',)
591	('591',)
491	('491',)
132	('132',)
852	('852',)
995	('995',)
116	('116',)
534	('534',)
598	('598',)
024	('024',)
418	('418',)
429	('429',)
876	('876',)
255	('255',)
678	('678',)
152	('152',)
375	('375',)
360	('360',)
413	('413',)
994	('994',)
184	('184',)
888	('888',)
026	('026',)
575	('575',)
309	('309',)
485	('485',)
728	('728',)
166	('166',)
275	('275',)
068	('068',)
472	('472',)
331	('331',)
916	('916',)
437	('437',)
376	('376',)
369	('369',)
878	('878',)
688	('688',)
203	('203',)
096	('096',)
061	('061',)
010	('010',)
970	('970',)
221	('221',)
265	('265',)
342	('342',)
992	('992',)
488	('488',)
427	('427',)
293	('293',)
570	('570',)
827	('827',)
568	('568',)
552	('552',)
477	('477',)
586	('586',)
744	('744',)
088	('088',)
490	('490',)
103	('103',)
629	('629',)
195	('195',)
510	('510',)
057	('057',)
596	('596',)
326	('326',)
538	('538',)
506	('506',)
048	('048',)
multipli	('multiplying', 'multiplied', 'multiplier')
january\xa028	('january\\xa028',)
724	('724',)
632	('632',)
480	('480',)
512	('512',)
452	('452',)
268	('268',)
septemb	('september',)
acquired\xa0on	('acquired\\xa0on',)
exercise\xa0	('exercise\\xa0',)
vesting\xa0	('vesting\\xa0',)
107	('107',)
809	('809',)
290	('290',)
792	('792',)
656	('656',)
126	('126',)
064	('064',)
179	('179',)
423	('423',)
835	('835',)
withheld	('withheld',)
030	('030',)
426	('426',)
\xa0\xa0\xa0\xa0our	('\\xa0\\xa0\\xa0\\xa0our',)
at-wil	('at-will',)
\xa0\xa0our	('\\xa0\\xa0our',)
surviv	('surviving',)
\xa0with	('\\xa0with',)
\xa0al	('\\xa0all',)
estimated\xa0benefit\xa0	('estimated\\xa0benefit\\xa0',)
113	('113',)
186	('186',)
958	('958',)
468	('468',)
990	('990',)
shortli	('shortly',)
997	('997',)
742	('742',)
760	('760',)
390	('390',)
070	('070',)
099	('099',)
187	('187',)
680	('680',)
913	('913',)
perman	('permanent', 'permanently')
foreign	('foreign',)
currenc	('currencies', 'currency')
convert	('converted', 'convertible')
methodolog	('methodology',)
$217	('$217',)
542	('542',)
employee\xa0pay	('employee\\xa0pay',)
ratio\xa0wa	('ratio\\xa0was',)
explain	('explained',)
desir	('desires', 'desirable', 'desire', 'desired')
fiscal\xa02022	('fiscal\\xa02022',)
fiscal\xa02021	('fiscal\\xa02021',)
762	('762',)
002	('002',)
708	('708',)
609	('609',)
281	('281',)
682	('682',)
862	('862',)
registr	('registration', 'registrant', 'registrants')
comfort	('comfort',)
pre-implement	('pre-implementation',)
attest	('attestation', 'attested', 'attest')
pre-approv	('pre-approved', 'pre-approval', 'pre-approvals', 'pre-approve')
compat	('compatible',)
audit-rel	('audit-related',)
case-by-cas	('case-by-case',)
unanticip	('unanticipated',)
\xa0mccafferi	('\\xa0mccaffery',)
irrespect	('irrespective',)
auditor	('auditors', 'auditor')
duplic	('duplicate',)
verif	('verification',)
opinion	('opinion', 'opinions')
conform	('conformity', 'conform')
par	('par',)
merit	('merits', 'merit')
741	('741',)
169	('169',)
sum	('sum',)
row	('rows', 'row')
unissu	('unissued',)
nor	('nor',)
privileg	('privileges',)
preemptiv	('preemptive',)
abandon	('abandon',)
expressli	('expressly',)
028	('028',)
valley	('valley',)
intens	('intense', 'intensive', 'intensely')
overhang	('overhang',)
weighted-averag	('weighted-average',)
96	('96',)
374	('374',)
961	('961',)
165	('165',)
$273	('$273',)
burn	('burn',)
651	('651',)
495	('495',)
16%	('16%',)
46%	('46%',)
73%	('73%',)
91%	('91%',)
45%	('45%',)
668	('668',)
608	('608',)
438	('438',)
624	('624',)
467	('467',)
175	('175',)
outlin	('outlined',)
entireti	('entirety',)
append	('appended',)
exert	('exert',)
nonstatutori	('nonstatutory',)
settl	('settled', 'settle')
newli	('newly',)
subsequ	('subsequent', 'subsequently')
proce	('proceeds',)
forfeit	('forfeited',)
358	('358',)
per-particip	('per-participant',)
strike	('strike',)
concurr	('concurrent', 'concurrently')
revest	('revest',)
itself	('itself',)
non-offic	('non-officer',)
re-grant	('re-grant',)
repeal	('repealed', 'repeal')
remuner	('remuneration',)
contract	('contract', 'contracts', 'contracted')
assur	('assurance', 'assurances')
iso	('isos', 'iso')
nso	('nsos', 'nso')
110%	('110%',)
die	('dies',)
short-sw	('short-swing',)
check	('check',)
draft	('draft',)
descent	('descent',)
domest	('domestic', 'domestically', 'domestication')
offici	('official',)
marit	('marital',)
fail	('fail', 'fails', 'failing', 'failed')
our	('ours',)
denomin	('denominated', 'denominator')
impos	('impose', 'imposed', 'imposes')
length	('length',)
thereof	('thereof',)
90th	('90th',)
elaps	('elapsed', 'elapses')
enumer	('enumerated',)
elimin	('eliminate', 'eliminated')
categor	('categorized',)
non-oper	('non-operating', 'non-operational')
depreci	('depreciation', 'depreciated')
reduct	('reduction', 'reductions')
satisfact	('satisfaction',)
infring	('infringement', 'infringe')
non-recur	('non-recurring',)
shut	('shutting', 'shut')
one-tim	('one-time',)
legisl	('legislation', 'legislative')
unusu	('unusual',)
infrequ	('infrequency',)
occurr	('occurrence',)
joint	('joint',)
reorgan	('reorganization',)
recapit	('recapitalization',)
spin-off	('spin-off',)
bonus	('bonuses',)
bonu	('bonus',)
impair	('impairment', 'impair', 'impaired', 'impairments', 'impairing')
long-liv	('long-lived',)
goodwil	('goodwill',)
donat	('donations',)
divest	('divested',)
whom	('whom',)
dodd	('dodd',)
frank	('frank',)
reacquisit	('reacquisition',)
proportion	('proportionately',)
es	('es',)
\xa0conting	('\\xa0contingent',)
laps	('lapse',)
consumm	('consummation', 'consummated', 'consummate')
\xa0a	('\\xa0a', '\\xa0as')
\xa0w	('\\xa0we',)
indirectli	('indirectly',)
thereto	('thereto',)
agre	('agreed',)
taxat	('taxation',)
exhaust	('exhaustive',)
section\xa0401	('section\\xa0401',)
1974	('1974',)
section\xa0162	('section\\xa0162',)
ordinari	('ordinary',)
section\xa0422	('section\\xa0422',)
disqualifi	('disqualifying', 'disqualify')
constitut	('constitutes', 'constituting', 'constitute')
sell	('sell', 'selling')
30\xa0	('30\\xa0',)
section\xa0409a	('section\\xa0409a',)
owe	('owe', 'owed')
tandem	('tandem',)
disallow	('disallows',)
enact	('enactment', 'enacted')
ambigu	('ambiguities',)
non-execut	('non-executive',)
former	('former',)
30-day	('30-day',)
420	('420',)
930	('930',)
549	('549',)
909	('909',)
982	('982',)
655	('655',)
516	('516',)
412	('412',)
535	('535',)
012	('012',)
204	('204',)
139	('139',)
732	('732',)
114	('114',)
848	('848',)
securities\xa0to\xa0b	('securities\\xa0to\\xa0be',)
issued\xa0upon\xa0exercis	('issued\\xa0upon\\xa0exercise',)
warrant	('warrants', 'warrant', 'warranted')
number\xa0of\xa0secur	('number\\xa0of\\xa0securities',)
remaining\xa0available\xa0for	('remaining\\xa0available\\xa0for',)
987	('987',)
785	('785',)
952	('952',)
discount	('discount', 'discounted')
pre-determin	('pre-determined',)
630	('630',)
871	('871',)
081	('081',)
164	('164',)
054	('054',)
670	('670',)
496	('496',)
592	('592',)
770	('770',)
327	('327',)
569	('569',)
767	('767',)
758	('758',)
section\xa016	('section\\xa016',)
furnish	('furnish', 'furnished')
herewith	('herewith',)
logo	('logo',)
trademark	('trademarks',)
paragraph	('paragraph',)
articl	('article',)
one-tenth	('one-tenth',)
cent	('cent',)
one-	('one-',)
tenth	('tenth',)
alter	('alter', 'altered')
wholli	('wholly',)
decreas	('decrease', 'decreased', 'decreases')
sentenc	('sentence',)
duli	('duly',)
fifth	('fifth',)
sixth	('sixth',)
wit	('witness', 'witnessed')
whereof	('whereof',)
________________________________________	('________________________________________',)
a-2	('a-2',)
[june	('[june',)
2022]	('2022]',)
portalplay	('portalplayer',)
collect	('collectively', 'collection', 'collectability', 'collecting', 'collected', 'collect', 'collections')
hereund	('hereunder',)
vi	('vi',)
vii	('vii',)
viii	('viii',)
notwithstand	('notwithstanding',)
anyth	('anything',)
tcja	('tcja',)
constru	('construe', 'construed')
omiss	('omission',)
inconsist	('inconsistency', 'inconsistent')
expedi	('expedient',)
controversi	('controversies', 'controversy', 'controversial')
suspend	('suspend', 'suspended')
suspens	('suspension',)
then-	('then-',)
nonqualifi	('nonqualified',)
therewith	('therewith',)
accru	('accruing', 'accrue', 'accrued')
thereund	('thereunder',)
16b-3	('16b-3',)
b-2	('b-2',)
clarifi	('clarify',)
sub-plan	('sub-plans',)
theretofor	('theretofore',)
subcommitte	('subcommittee',)
sar	('sars', 'sar')
himself	('himself',)
herself	('herself',)
construct	('constructions', 'constructively', 'construction', 'constructing')
faith	('faith',)
conclus	('conclusive', 'conclusion', 'conclusively', 'conclusions')
neither	('neither',)
twelv	('twelve',)
b-3	('b-3',)
766	('766',)
reapprov	('reapproved',)
733	('733',)
298	('298',)
4-for-1	('4-for-1',)
clariti	('clarity',)
5635	('5635',)
manual	('manual',)
303a	('303a',)
08	('08',)
amex	('amex',)
711	('711',)
revers	('reversion',)
forfeitur	('forfeiture', 'forfeitures')
z	('z',)
revert	('revert',)
___________	('___________',)
845	('845',)
3-for-2	('3-for-2',)
b-4	('b-4',)
reacquir	('reacquired',)
424	('424',)
405	('405',)
spin	('spin',)
s-8	('s-8',)
shorter	('shorter',)
b-5	('b-5',)
longer	('longer',)
absenc	('absence',)
subsect	('subsections',)
explicitli	('explicitly',)
satisfactori	('satisfactory',)
executor	('executor',)
difficult	('difficult',)
b-6	('b-6',)
bequest	('bequest',)
inherit	('inheritance',)
non-exempt	('non-exempt',)
labor	('labor',)
1938	('1938',)
suffer	('suffers',)
b-7	('b-7',)
book	('book', 'books')
\xa0evidenc	('\\xa0evidenced',)
long	('long',)
b-8	('b-8',)
induc	('inducement',)
commenc	('commencement', 'commencing', 'commence', 'commenced')
coven	('covenants', 'covenant')
b-9	('b-9',)
unreason	('unreasonable',)
reliev	('relieved',)
furthermor	('furthermore',)
warn	('warn',)
pend	('pending',)
miscellan	('miscellaneous',)
cleric	('clerical',)
incorrect	('incorrect',)
full-tim	('full-time',)
part-tim	('part-time',)
correspond	('corresponding', 'correspond')
lieu	('lieu',)
optionhold	('optionholder',)
b-10	('b-10',)
inop	('inoperative',)
legend	('legends',)
\xa0\xa0withhold	('\\xa0\\xa0withholding',)
classif	('classification',)
gov	('gov',)
intranet	('intranet',)
lump	('lump',)
silent	('silent',)
b-11	('b-11',)
dissolut	('dissolution',)
liquid	('liquidation', 'liquidating', 'liquidity', 'liquid')
b-12	('b-12',)
10th	('10th',)
anytim	('anytime',)
b-13	('b-13',)
reincorpor	('reincorporation', 'reincorporated')
will	('willful',)
convict	('conviction',)
guilti	('guilty',)
plea	('plea',)
feloni	('felony',)
crime	('crime',)
moral	('moral',)
turpitud	('turpitude',)
perpetr	('perpetration',)
dishonesti	('dishonesty',)
breach	('breach', 'breaches')
refus	('refusal',)
disregard	('disregard',)
injuri	('injury', 'injurious')
b-14	('b-14',)
leas	('lease', 'leased', 'leases')
ceas	('cease', 'ceases', 'ceased')
subscrib	('subscribe',)
domicil	('domicile',)
analog	('analogous',)
supersed	('supersede',)
takeov	('takeover',)
409a-3	('409a-3',)
interrupt	('interrupted', 'interruption')
b-15	('b-15',)
leav	('leave',)
sick	('sick',)
company-paid	('company-paid',)
vacat	('vacation',)
float	('floating',)
409a-1	('409a-1',)
inabl	('inability',)
w	('w',)
fiduciari	('fiduciary',)
b-16	('b-16',)
underwrit	('underwriter',)
temporarili	('temporarily',)
fifti	('fifty',)
quot	('quoted',)
reliabl	('reliable', 'reliability', 'reliably')
quotat	('quotation',)
aa	('aa',)
404	('404',)
item\xa0404	('item\\xa0404',)
bb	('bb',)
dd	('dd',)
ee	('ee',)
ff	('ff',)
gg	('gg',)
hh	('hh',)
tax-qualifi	('tax-qualified',)
b-17	('b-17',)
jj	('jj',)
kk	('kk',)
ll	('ll',)
mm	('mm',)
\xa0cash	('\\xa0cash',)
nn	('nn',)
b-18	('b-18',)
oo	('oo',)
overlap	('overlapping',)
durat	('duration',)
pp	('pp',)
qq	('qq',)
rr	('rr',)
ss	('ss',)
tt	('tt',)
uu	('uu',)
vv	('vv',)
ww	('ww',)
xx	('xx',)
yy	('yy',)
zz	('zz',)
bbb	('bbb',)
ccc	('ccc',)
might	('might',)
happen	('happening', 'happened')
b-19	('b-19',)
indirect	('indirect',)
ddd	('ddd',)
b-20	('b-20',)
washington	('washington',)
\xa020549	('\\xa020549',)
____________________________________________________________________________________________	('____________________________________________________________________________________________',)
\u2612	('\\u2612',)
\u2610	('\\u2610',)
0-23985	('0-23985',)
exact	('exact',)
94-3177549	('94-3177549',)
california\xa095051	('california\\xa095051',)
zip	('zip',)
symbol	('symbol',)
well-known	('well-known',)
issuer	('issuer', 'issuers')
ye	('yes',)
s-t	('s-t',)
\xa7232	('\\xa7232',)
filer	('filer',)
non-acceler	('non-accelerated',)
12b-2	('12b-2',)
revis	('revised', 'revisions', 'revise')
sarbanes-oxley	('sarbanes-oxley',)
7262	('7262',)
shell	('shell',)
july\xa030	('july\\xa030',)
$467	('$467',)
99	('99',)
1940	('1940',)
march\xa011	('march\\xa011',)
51\xa0billion	('51\\xa0billion',)
10-14	('10-14',)
unresolv	('unresolved',)
comment	('comments',)
mine	('mine', 'mining')
7a	('7a',)
quantit	('quantitative',)
qualit	('qualitative',)
supplementari	('supplementary',)
disagr	('disagreements',)
9a	('9a',)
9c	('9c',)
signatur	('signatures', 'signature')
channel	('channels', 'channel')
fd	('fd',)
twitter	('twitter',)
blog	('blog', 'blogs')
facebook	('facebook',)
linkedin	('linkedin',)
instagram	('instagram',)
youtub	('youtube',)
section\xa027a	('section\\xa027a',)
section\xa021	('section\\xa021e',)
harbor	('harbor',)
unknown	('unknown',)
frame	('frames', 'frame')
undu	('undue',)
cautionari	('cautionary',)
incomplet	('incomplete',)
caution	('cautioned',)
unduli	('unduly',)
\xa9	('\\xa9',)
gtx	('gtx',)
mellanox	('mellanox', 'mellanoxs')
ngc	('ngc',)
constel	('constellation',)
shield	('shield',)
vgpu	('vgpu',)
augment	('augmented', 'augment')
ar	('ar',)
vr	('vr',)
imagin	('imagination', 'imagine')
film	('films',)
parallel	('parallel',)
brain	('brain',)
multi-billion-dollar	('multi-billion-dollar',)
$29	('$29',)
yield	('yielding', 'yields', 'yield')
introduct	('introduction', 'introductions')
bio-scienc	('bio-science',)
fastest	('fastest',)
cpu-bas	('cpu-based',)
pace	('pace',)
enjoy	('enjoy',)
immers	('immersive',)
cinemat	('cinematic',)
underpin	('underpin',)
spectat	('spectator',)
sport	('sport',)
esport	('esports',)
viewer	('viewers',)
watch	('watch',)
top-qual	('top-quality',)
burgeon	('burgeoning',)
popul	('population',)
streamer	('streamers',)
broadcast	('broadcasters',)
molecular	('molecular',)
tunnel	('tunnel',)
genom	('genomics',)
enrich	('enrich', 'enrichment')
end-us	('end-users',)
shop	('shopping',)
rapidli	('rapidly',)
turn	('turning', 'turn')
detect	('detection', 'detect', 'detected')
movi	('movies', 'movie')
write-off	('write-off', 'write-offs')
prepay	('prepayment', 'prepayments', 'prepay')
cryptocurr	('cryptocurrency', 'cryptocurrencies')
cmp	('cmp',)
predomin	('predominant',)
franchis	('franchises',)
modder	('modders',)
sophist	('sophisticated',)
smoother	('smoother',)
cinematic-qu	('cinematic-quality',)
techniqu	('technique', 'techniques')
realism	('realism',)
computer-gener	('computer-generated',)
sampl	('sampling', 'samples')
boost	('boosts', 'boost', 'boosting')
beauti	('beautiful',)
underpow	('underpowered',)
tv	('tv',)
bodi	('body', 'bodies')
standalon	('standalone',)
often	('often',)
greatli	('greatly',)
multitud	('multitude',)
oil	('oil',)
drill	('drilling',)
alphabet	('alphabet',)
se	('se',)
user	('users', 'user')
inferenc	('inferencing',)
hewlett	('hewlett',)
packard	('packard',)
hitachi	('hitachi',)
vantara	('vantara',)
inspur	('inspur',)
alicloud	('alicloud',)
baidu	('baidu',)
tencent	('tencent',)
ready-to-us	('ready-to-use',)
data-center-	('data-center-',)
infrastructure-on-a-chip	('infrastructure-on-a-chip',)
hardware-acceler	('hardware-accelerated',)
domain-specif	('domain-specific',)
registri	('registry',)
catalog	('catalog',)
get	('get',)
nvidia-certifi	('nvidia-certified',)
perpetu	('perpetual',)
enterprise-grad	('enterprise-grade',)
command	('command',)
software-as-a-servic	('software-as-a-service',)
multi-us	('multi-user',)
multi-team	('multi-team',)
workflow	('workflows',)
graphics-rich	('graphics-rich',)
vendor	('vendors',)
isv	('isvs',)
encompass	('encompass',)
consumer-product	('consumer-products',)
edit	('editing',)
post-	('post-',)
broadcast-televis	('broadcast-television',)
film-qual	('film-quality',)
shadow	('shadows',)
refract	('refractions',)
mirror	('mirror',)
physically-bas	('physically-based',)
long-stand	('long-standing',)
pilot	('pilot',)
mode	('mode',)
co-pilot	('co-pilot',)
safer	('safer',)
automak	('automakers',)
tier-	('tier-',)
hd	('hd',)
map	('mapping', 'map')
modular	('modular',)
chauffeur	('chauffeur',)
park	('parking',)
concierg	('concierge',)
in-vehicl	('in-vehicle',)
precis	('precisely', 'precision')
fusion	('fusion',)
surround	('surround',)
palm-siz	('palm-sized',)
energy-	('energy-',)
modul	('module',)
highway-driv	('highway-driving',)
driverless	('driverless',)
newest	('newest',)
system-on-a-chip	('system-on-a-chip',)
autopilot	('autopilot',)
see	('sees',)
center-bas	('center-based',)
sim	('sim',)
over-the-air	('over-the-air',)
inde	('indeed',)
unsolv	('unsolvable',)
leap	('leaps', 'leap', 'leaped')
advantag	('advantages', 'advantage')
legaci	('legacy',)
block	('blocks', 'blocked', 'block')
r&d	('r&d',)
ai-specif	('ai-specific',)
reinforc	('reinforced', 'reinforce')
virtuou	('virtuous',)
evangel	('evangelize',)
industry-lead	('industry-leading',)
gameplay	('gameplay',)
studio	('studio', 'studios')
empow	('empowers',)
photo	('photo',)
anywher	('anywhere',)
advent	('advent',)
too	('too',)
hand-cod	('hand-coded',)
ai-	('ai-',)
tier-1	('tier-1',)
start-up	('start-ups',)
gpu-bas	('gpu-based',)
re-simul	('re-simulate',)
odm	('odms',)
add-in	('add-in',)
aib	('aibs',)
distributor	('distributors',)
depth	('depth',)
time-to-market	('time-to-market',)
personnel	('personnel',)
evolv	('evolved', 'evolving', 'evolve')
avenu	('avenues',)
thu	('thus',)
e-tail	('e-tail',)
half	('half',)
notebook	('notebooks', 'notebook')
weaker	('weaker',)
supply-constrain	('supply-constrained',)
repeat	('repeat',)
fabless	('fabless',)
wafer	('wafer', 'wafers')
procur	('procure', 'procurement')
substrat	('substrates',)
non-cancel	('non-cancellable', 'non-cancelable')
premium	('premiums', 'premium')
deposit	('deposits', 'deposit')
samsung	('samsung',)
ltd	('ltd',)
subcontractor	('subcontractors', 'subcontractor')
amkor	('amkor',)
king	('king',)
yuan	('yuan',)
omni	('omni',)
siliconwar	('siliconware',)
wistron	('wistron',)
flex	('flex',)
jabil	('jabil',)
fabrinet	('fabrinet',)
cabl	('cables', 'cable')
ibiden	('ibiden',)
kinsu	('kinsus',)
unimicron	('unimicron',)
micron	('micron',)
sk	('sk',)
hynix	('hynix',)
consign	('consign',)
circuit	('circuit', 'circuits')
advantest	('advantest',)
byd	('byd',)
hon	('hon',)
hai	('hai',)
motherboard	('motherboard',)
aic	('aic',)
hong	('hong',)
kong	('kong',)
israel	('israel',)
character	('characterized',)
breadth	('breadth',)
entrant	('entrants',)
semiconductor-bas	('semiconductor-based',)
fibr	('fibre',)
licensor	('licensors',)
amd	('amd',)
alibaba	('alibaba',)
ambarella	('ambarella',)
renesa	('renesas',)
motor	('motors',)
optoelectron	('optoelectronics',)
arista	('arista',)
junip	('juniper',)
lumentum	('lumentum',)
patent	('patents', 'patent')
secret	('secrets',)
nondisclosur	('nondisclosure',)
2045	('2045',)
treati	('treaties',)
asia	('asia',)
piraci	('piracy',)
export	('export', 'exports', 'exporting')
tariff	('tariffs',)
anti-corrupt	('anti-corruption',)
repatri	('repatriation', 'repatriate', 'repatriating')
antitrust	('antitrust',)
1985	('1985',)
corewar	('coreware',)
1983	('1983',)
microprocessor	('microprocessor',)
arizona	('arizona',)
methodist	('methodist',)
22-year	('22-year',)
hewlett-packard	('hewlett-packard',)
booz	('booz',)
allen	('allen',)
hamilton	('hamilton',)
minnesota	('minnesota',)
uniphas	('uniphase',)
optic	('optical',)
telecommun	('telecommunications',)
electro-opt	('electro-optics',)
laser	('laser',)
hard	('hard',)
disk	('disk',)
kansa	('kansas',)
missil	('missiles',)
harm	('harm', 'harmed', 'harms', 'harming')
lose	('lose',)
immateri	('immaterial',)
e-	('e-',)
commerc	('commerce', 'commerces')
lengthi	('lengthy',)
incompat	('incompatible',)
prevail	('prevailing',)
intensifi	('intensify',)
cheaper	('cheaper',)
in-hous	('in-house',)
entail	('entails',)
mismatch	('mismatch', 'mismatches')
blockchain-bas	('blockchain-based',)
ethereum	('ethereum',)
verifi	('verifying',)
blockchain	('blockchain',)
aftermarket	('aftermarket',)
resal	('resales', 'resale')
lite	('lite',)
hash	('hash',)
lhr	('lhr',)
miner	('miners', 'minerals')
attempt	('attempts',)
resold	('resold',)
unauthor	('unauthorized',)
gray	('gray',)
shortag	('shortages', 'shortage')
perish	('perishable',)
disappear	('disappear',)
perhap	('perhaps',)
shorten	('shorten',)
finish	('finished',)
write-down	('write-down', 'write-downs')
incorrectli	('incorrectly',)
confid	('confidence',)
downturn	('downturns',)
economi	('economy',)
incid	('incidence', 'incident')
obsolesc	('obsolescence',)
spike	('spikes',)
underestim	('underestimate',)
lead-tim	('lead-time', 'lead-times')
fill	('fill', 'filled')
constraint	('constraints',)
disast	('disasters', 'disaster')
begun	('begun',)
trigger	('trigger',)
neg	('negatively', 'negative')
lack	('lack', 'lacking')
decommit	('decommitment',)
geometri	('geometry',)
remedi	('remediate', 'remedial', 'remediated', 'remediation', 'remedies', 'remedy')
vulner	('vulnerabilities', 'vulnerable', 'vulnerability')
unsatisfactori	('unsatisfactory',)
discov	('discovered', 'discover')
undiscov	('undiscovered',)
unscrupul	('unscrupulous',)
malici	('malicious',)
attack	('attack', 'attacks')
tier	('tier',)
warranti	('warranty', 'warranties')
repair	('repair',)
recal	('recall',)
divert	('divert',)
claim	('claim', 'claims', 'claimed')
defend	('defending', 'defend', 'defendants')
inadequ	('inadequate',)
84%	('84%',)
war	('war',)
terror	('terrorism',)
catastroph	('catastrophic',)
recess	('recession',)
slow	('slowing', 'slow', 'slowed')
monetari	('monetary',)
tighter	('tighter',)
inflat	('inflation',)
unemploy	('unemployment',)
wide-rang	('wide-ranging',)
license	('licensees',)
insolv	('insolvency',)
back	('back',)
exit	('exit', 'exited')
merg	('merge',)
bankruptci	('bankruptcy',)
counterparti	('counterparties',)
boycott	('boycott', 'boycotts')
isra	('israeli',)
water	('water',)
heat	('heat',)
coupl	('coupled',)
dri	('dry',)
northern	('northern',)
wildfir	('wildfire', 'wildfires')
instabl	('instability',)
attrit	('attrition',)
casualti	('casualty',)
unwil	('unwilling',)
climate-	('climate-',)
carbon	('carbon',)
pollut	('pollution',)
pass	('passed',)
insuffici	('insufficiently',)
disput	('disputes',)
change-rel	('change-related',)
influenc	('influenced',)
despit	('despite',)
hurt	('hurt',)
cyber-attack	('cyber-attacks',)
malwar	('malware',)
social-engin	('social-engineering',)
denial-of-servic	('denial-of-service',)
bug	('bugs',)
malfunct	('malfunctions',)
cyber-	('cyber-',)
awar	('aware', 'awareness')
crimin	('criminal',)
actor	('actors',)
credenti	('credentials',)
decept	('deception', 'deceptive')
two-factor	('two-factor',)
authent	('authentication',)
misappropri	('misappropriated', 'misappropriation')
leak	('leaked',)
harden	('hardened',)
exfiltr	('exfiltrated',)
ransomwar	('ransomware',)
nation-st	('nation-states',)
nation-state-	('nation-state-',)
preval	('prevalent',)
backup	('backups',)
restor	('restoring',)
feasibl	('feasible', 'feasibility')
nation-state-support	('nation-state-supported',)
geopolit	('geopolitical',)
heighten	('heightened',)
encrypt	('encryption',)
compromis	('compromised',)
exploit	('exploitable',)
log	('logs',)
alway	('always',)
unapprov	('unapproved',)
dissemin	('dissemination',)
misus	('misuse',)
indemnif	('indemnification', 'indemnifications')
lost	('lost',)
outag	('outages',)
terrorist	('terrorist',)
violenc	('violence',)
unrest	('unrest',)
epidem	('epidemics',)
man-mad	('man-made',)
earthquak	('earthquakes',)
geograph	('geographical', 'geographic')
russia	('russia',)
ukrain	('ukraine',)
fewer	('fewer',)
littl	('little',)
penalti	('penalty', 'penalties')
discontinu	('discontinue',)
extern	('external',)
immigr	('immigration',)
longstand	('longstanding',)
smooth	('smooth',)
hinder	('hinder',)
proper	('proper',)
erp	('erp',)
costli	('costly',)
weak	('weaknesses', 'weakness')
inaccur	('inaccurate',)
sanction	('sanctions',)
certainti	('certainty',)
pose	('posed', 'poses')
diseas	('disease',)
reopen	('reopen', 'reopened')
increment	('incremental',)
onsit	('onsite',)
in-offic	('in-office',)
though	('though',)
offset	('offset', 'offsets', 'offsetting')
shortfal	('shortfalls',)
bad	('bad',)
oner	('onerous',)
corrupt	('corrupt',)
one	('ones',)
anti-competit	('anti-competition',)
concentr	('concentration', 'concentrated', 'concentrations')
decre	('decrees',)
quota	('quotas',)
barrier	('barriers',)
russian	('russian',)
alli	('allies',)
deal	('dealings', 'dealing', 'deal')
passag	('passage',)
ukrainian	('ukrainian',)
tension	('tensions', 'tension')
korea	('korea',)
abroad	('abroad',)
chines	('chinese',)
imposit	('imposition',)
retaliatori	('retaliatory',)
resolv	('resolve', 'resolved')
draw	('draw',)
undermin	('undermine',)
scrutini	('scrutiny',)
unsuccess	('unsuccessful',)
alleg	('alleging', 'alleged')
unfavor	('unfavorable',)
invalid	('invalidation',)
injunct	('injunctive', 'injunction')
countersuit	('countersuits',)
indemnite	('indemnitees', 'indemnitee')
royalti	('royalty', 'royalties')
cross	('cross',)
theft	('theft',)
stringent	('stringent',)
deter	('deter',)
privacy-rel	('privacy-related',)
unfound	('unfounded',)
european	('european',)
union	('union',)
gdpr	('gdpr', 'gdprs')
strict	('strict',)
handl	('handling',)
eea	('eea',)
store	('stored', 'store', 'stores')
delet	('delete',)
\u20ac20	('\\u20ac20',)
4%	('4%',)
whichev	('whichever',)
cross-bord	('cross-border',)
claus	('clauses',)
validli	('validly',)
europ	('europe',)
notif	('notification',)
ccpa	('ccpa',)
opt-out	('opt-out',)
cpra	('cpra',)
cross-contextu	('cross-contextual',)
virginia	('virginia',)
colorado	('colorado',)
fashion	('fashion',)
necessit	('necessitate',)
ban	('bans',)
destroy	('destroy',)
multin	('multinational',)
non-income-bas	('non-income-based',)
value-ad	('value-added',)
examin	('examination', 'examining')
germani	('germany',)
disagre	('disagree',)
non-incom	('non-income',)
congress	('congress',)
intergovernment	('intergovernmental',)
oecd	('oecd',)
taxpay	('taxpayers',)
fifteen	('fifteen',)
valuat	('valuation',)
defici	('deficiencies', 'deficient')
statut	('statute',)
appeal	('appeal', 'appeals')
dismiss	('dismissal', 'dismiss')
assert	('assert', 'asserted', 'asserts', 'asserting')
fals	('false',)
mislead	('misleading',)
stop	('stopping', 'stopped')
compulsori	('compulsory',)
indebted	('indebtedness',)
2060	('2060',)
matur	('matures', 'maturity', 'maturities', 'mature')
redeem	('redeemed', 'redeem')
$575	('$575',)
react	('reacting',)
lien	('liens',)
indentur	('indenture',)
lender	('lenders',)
anti-takeov	('anti-takeover',)
discourag	('discourage',)
super-major	('super-majority',)
xbox	('xbox',)
someon	('someone',)
76\xa0million	('76\\xa0million',)
feet	('feet',)
campu	('campus',)
suitabl	('suitable',)
select\xa0market	('select\\xa0market',)
approximately\xa0313	('approximately\\xa0313',)
of\xa01	('of\\xa01',)
04	('04',)
billion\xa0shar	('billion\\xa0shares',)
of\xa0$7	('of\\xa0$7',)
negoti	('negotiated',)
10b-18	('10b-18',)
paid\xa0$399	('paid\\xa0$399',)
million\xa0in	('million\\xa0in',)
349\xa0million	('349\\xa0million',)
approximately\xa08	('approximately\\xa08',)
million\xa0shar	('million\\xa0shares',)
through\xa0net	('through\\xa0net',)
paid-in	('paid-in',)
unregist	('unregistered',)
333	('333',)
graphs\xa0	('graphs\\xa0',)
january\xa0	('january\\xa0',)
january\xa029	('january\\xa029',)
return*	('return*',)
01	('01',)
*$100	('*$100',)
factset	('factset',)
218	('218',)
226	('226',)
470	('470',)
174	('174',)
97	('97',)
215	('215',)
79	('79',)
303	('303',)
operations\xa0	('operations\\xa0',)
conjunct	('conjunction',)
non-min	('non-mining',)
pre-pandem	('pre-pandemic',)
pronounc	('pronounced', 'pronouncements', 'pronouncement')
prove	('prove', 'proves')
quicker	('quicker',)
pent-up	('pent-up',)
broaden	('broadening',)
constrain	('constrained',)
non-linear	('non-linear',)
paus	('paused',)
travel	('travel',)
434	('434',)
27%	('27%',)
332	('332',)
much	('much',)
proof	('proof',)
stake	('stake',)
degrad	('degrade',)
$550	('$550',)
$161	('$161',)
compensation-rel	('compensation-related',)
$21	('$21',)
riva	('riva',)
modulu	('modulus',)
reopt	('reopt',)
quantum-2	('quantum-2',)
400gbp	('400gbps',)
line-up	('line-ups',)
uniti	('unity',)
a30	('a30',)
a10	('a10',)
debut	('debuted',)
crisi	('crisis',)
atlan	('atlan',)
eq	('eqs',)
sedan	('sedan',)
volvo	('volvo',)
next-	('next-',)
xc90	('xc90',)
r-auto	('r-auto',)
im	('im',)
nio	('nio',)
faraday	('faraday',)
vinfast	('vinfast',)
robotaxi	('robotaxis', 'robotaxi')
cruis	('cruise',)
zoox	('zoox',)
poni	('pony',)
autox	('autox',)
embark	('embark',)
kodiak	('kodiak',)
jointli	('jointly',)
desay	('desay',)
quanta	('quanta',)
valeo	('valeo',)
zf	('zf',)
on-go	('on-going',)
10-	('10-',)
first-in	('first-in',)
first-out	('first-out',)
obsolet	('obsolete',)
sudden	('sudden',)
insignific	('insignificant',)
maxim	('maximizing',)
observ	('observable', 'observed')
ratabl	('ratably',)
rebat	('rebates',)
resel	('resellers', 'reseller')
mdf	('mdfs',)
moni	('monies',)
earmark	('earmarked',)
refund	('refundable',)
temporari	('temporary',)
carryforward	('carryforwards', 'carryforward')
unnecessari	('unnecessary',)
$907\xa0million	('$907\\xa0million',)
more-	('more-',)
likely-than-not	('likely-than-not',)
more-likely-than-not	('more-likely-than-not',)
unrecogn	('unrecognized',)
unit\xa0in	('unit\\xa0in',)
35\xa0	('35\\xa0',)
$361\xa0million	('$361\\xa0million',)
99\xa0billion	('99\\xa0billion',)
unpredict	('unpredictable',)
834	('834',)
034	('034',)
046	('046',)
841	('841',)
205	('205',)
vertic	('vertical',)
for\xa084%	('for\\xa084%',)
81%	('81%',)
years\xa02022	('years\\xa02022',)
overhead	('overhead',)
fallout	('fallout',)
$354	('$354',)
$116	('$116',)
written-off	('written-off',)
written-down	('written-down',)
$111	('$111',)
$145	('$145',)
924	('924',)
12%	('12%',)
$57	('$57',)
coupon	('coupon',)
$236	('$236',)
$184	('$184',)
$107	('$107',)
part\xa0iv	('part\\xa0iv',)
item\xa015	('item\\xa015',)
$189	('$189',)
$77	('$77',)
foreign-deriv	('foreign-derived',)
21%	('21%',)
british	('british',)
virgin	('virgin',)
830	('830',)
865	('865',)
forese	('foreseeable',)
\xa0govern	('\\xa0government',)
accumul	('accumulated',)
2028	('2028',)
2031	('2031',)
2040	('2040',)
2050	('2050',)
$729	('$729',)
$59	('$59',)
non-curr	('non-current',)
climate-rel	('climate-related',)
1\xa0	('1\\xa0',)
part\xa0	('part\\xa0',)
item\xa0	('item\\xa0',)
for\xa0a	('for\\xa0a',)
fixed-r	('fixed-rate',)
curv	('curve',)
zero	('zero',)
floor	('floor',)
$33	('$33',)
unamort	('unamortized',)
sheet	('sheets', 'sheet')
bear	('bear',)
remeasur	('remeasurement', 'remeasured')
movement	('movements',)
spot	('spot',)
reclassifi	('reclassified', 'reclassify')
ineffect	('ineffectiveness',)
$103	('$103',)
$84	('$84',)
$41	('$41',)
$44	('$44',)
item\xa08	('item\\xa08',)
item\xa09a	('item\\xa09a',)
13a-15	('13a-15',)
rule\xa0	('rule\\xa0',)
supervis	('supervision',)
sponsor	('sponsoring', 'sponsors')
treadway	('treadway',)
ledger	('ledger',)
conceiv	('conceived',)
item\xa09b	('item\\xa09b',)
\xa0\xa0oth	('\\xa0\\xa0other',)
part\xa0iii	('part\\xa0iii',)
omit	('omitted',)
regulation\xa014a	('regulation\\xa014a',)
120\xa0day	('120\\xa0days',)
caption	('caption', 'captions', 'captioned')
\xa0compens	('\\xa0compensation',)
compensation\xa0and	('compensation\\xa0and',)
-\xa0independ	('-\\xa0independence',)
pcaob	('pcaob',)
id	('id',)
238	('238',)
coso	('coso',)
fairli	('fairly',)
misstat	('misstatement', 'misstatements')
deterior	('deteriorate',)
especi	('especially',)
605	('605',)
accuraci	('accuracy',)
jose	('jose',)
march\xa017	('march\\xa017',)
829	('829',)
178	('178',)
236	('236',)
124	('124',)
409	('409',)
189	('189',)
796	('796',)
basic	('basic',)
available-for-sal	('available-for-sale',)
reclassif	('reclassification', 'reclassifications')
350	('350',)
826	('826',)
prepaid	('prepaid', 'prepaids')
366	('366',)
055	('055',)
778	('778',)
707	('707',)
349	('349',)
193	('193',)
339	('339',)
222	('222',)
791	('791',)
777	('777',)
335	('335',)
925	('925',)
964	('964',)
634	('634',)
553	('553',)
898	('898',)
issued\xa0and	('issued\\xa0and',)
859	('859',)
479	('479',)
january\xa031	('january\\xa031',)
719	('719',)
380	('380',)
756	('756',)
235	('235',)
612	('612',)
common\xa0stock	('common\\xa0stock',)
263	('263',)
565	('565',)
plans\xa0	('plans\\xa0',)
551	('551',)
043	('043',)
814	('814',)
194	('194',)
86	('86',)
reconcil	('reconcile', 'reconciling')
098	('098',)
774	('774',)
597	('597',)
715	('715',)
394	('394',)
163	('163',)
197	('197',)
023	('023',)
527	('527',)
365	('365',)
787	('787',)
461	('461',)
145	('145',)
977	('977',)
782	('782',)
52-	('52-',)
wholly-own	('wholly-owned',)
intercompani	('intercompany',)
mainli	('mainly',)
when-and-if	('when-and-if',)
unspecifi	('unspecified',)
front	('front',)
host	('hosted', 'host')
subscription-bas	('subscription-based',)
mont	('monte',)
carlo	('carlo',)
market-bas	('market-based',)
requisit	('requisite', 'requisitions')
black-schol	('black-scholes',)
judgement	('judgements',)
end-of-period	('end-of-period',)
non-monetari	('non-monetary',)
$907	('$907',)
anti-dilut	('anti-dilutive',)
readili	('readily',)
classifi	('classify', 'classified')
interest-bear	('interest-bearing',)
specific-identif	('specific-identification',)
short	('short',)
cash-	('cash-',)
highly-r	('highly-rated',)
written-up	('written-up',)
noncancel	('noncancelable',)
remov	('removed', 'removing')
thirti	('thirty',)
leasehold	('leasehold',)
non-leas	('non-lease',)
\xa0for	('\\xa0for',)
our\xa0impair	('our\\xa0impairment',)
we\xa0perform	('we\\xa0perform',)
analysis\xa0on	('analysis\\xa0on',)
residu	('residual',)
in-process	('in-process',)
ipr&d	('ipr&d',)
finit	('finite',)
twenti	('twenty',)
indefinit	('indefinite', 'indefinitely')
amortiz	('amortizable',)
whenev	('whenever',)
recover	('recoverable', 'recoverability')
undiscount	('undiscounted',)
tangibl	('tangible',)
non-market	('non-marketable',)
privately-held	('privately-held',)
unobserv	('unobservable',)
inact	('inactive', 'inactions')
investe	('investee',)
publicly-held	('publicly-held',)
octob	('october',)
606	('606',)
36\xa0	('36\\xa0',)
13\xa0	('13\\xa0',)
033	('033',)
134	('134',)
115	('115',)
320	('320',)
431	('431',)
$125	('$125',)
56\xa0	('56\\xa0',)
249\xa0	('249\\xa0',)
pre-combin	('pre-combination',)
$28\xa0million	('$28\\xa0million',)
440	('440',)
backlog	('backlog',)
190	('190',)
finite-liv	('finite-lived',)
multi-period	('multi-period',)
relief-from-royalti	('relief-from-royalty',)
indefinite-liv	('indefinite-lived',)
$630\xa0	('$630\\xa0',)
unaudit	('unaudited',)
forma	('forma',)
757	('757',)
necessarili	('necessarily',)
$161\xa0million	('$161\\xa0million',)
nonrecur	('nonrecurring',)
2035	('2035',)
in\xa0million	('in\\xa0millions',)
2027	('2027',)
885	('885',)
$169\xa0million	('$169\\xa0million',)
$168	('$168',)
$114	('$114',)
154	('154',)
$80\xa0million	('$80\\xa0million',)
87%	('87%',)
statements\xa0	('statements\\xa0',)
449	('449',)
grant-dat	('grant-date',)
764	('764',)
using\xa0th	('using\\xa0the',)
1-2	('1-2',)
risk-fre	('risk-free',)
%-0	('%-0',)
1%-1	('1%-1',)
5%-2	('5%-2',)
20%-58%	('20%-58%',)
26%-89%	('26%-89%',)
30%-82%	('30%-82%',)
1%-0	('1%-0',)
3%-0	('3%-0',)
market-	('market-',)
semi-annu	('semi-annually',)
non-statutori	('non-statutory',)
6\xa0million	('6\\xa0million',)
131	('131',)
four-year	('four-year',)
85%	('85%',)
233\xa0million	('233\\xa0million',)
grant-	('grant-',)
of\xa0january\xa030	('of\\xa0january\\xa030',)
2022\xa0and\xa0january\xa031	('2022\\xa0and\\xa0january\\xa031',)
intrins	('intrinsic',)
38\xa0billion	('38\\xa0billion',)
$741\xa0million	('$741\\xa0million',)
$521\xa0million	('$521\\xa0million',)
$84\xa0million	('$84\\xa0million',)
january\xa026	('january\\xa026',)
56\xa0billion	('56\\xa0billion',)
67\xa0billion	('67\\xa0billion',)
45\xa0billion	('45\\xa0billion',)
35\xa0billion	('35\\xa0billion',)
$361\xa0	('$361\\xa0',)
99\xa0	('99\\xa0',)
19\xa0billion	('19\\xa0billion',)
$347\xa0	('$347\\xa0',)
85\xa0	('85\\xa0',)
$156\xa0million	('$156\\xa0million',)
$143\xa0million	('$143\\xa0million',)
$13\xa0	('$13\\xa0',)
net\xa0	('net\\xa0',)
304	('304',)
717	('717',)
225	('225',)
706	('706',)
135	('135',)
986	('986',)
$630\xa0million	('$630\\xa0million',)
$563	('$563',)
$612	('$612',)
$585	('$585',)
$461	('$461',)
$405	('$405',)
$121	('$121',)
102	('102',)
bond	('bonds',)
695	('695',)
442	('442',)
234	('234',)
states\xa0govern	('states\\xa0government',)
975	('975',)
313	('313',)
637	('637',)
breakdown	('breakdown',)
445	('445',)
464	('464',)
584	('584',)
566	('566',)
hierarchi	('hierarchy',)
fair\xa0value\xa0at	('fair\\xa0value\\xa0at',)
011	('011',)
309%	('309%',)
584%	('584%',)
00%	('00%',)
066	('066',)
147	('147',)
602	('602',)
$48\xa0million	('$48\\xa0million',)
publicly-trad	('publicly-traded',)
692	('692',)
useful\xa0lif	('useful\\xa0life',)
furnitur	('furniture',)
874	('874',)
3-5	('3-5',)
558	('558',)
681	('681',)
903	('903',)
non-depreci	('non-depreciable',)
lesser	('lesser',)
$611	('$611',)
$486	('$486',)
$355	('$355',)
$265	('$265',)
$223	('$223',)
$258\xa0million	('$258\\xa0million',)
$157\xa0million	('$157\\xa0million',)
$212\xa0million	('$212\\xa0million',)
747	('747',)
357	('357',)
accrual	('accruals', 'accrual')
297	('297',)
647	('647',)
241	('241',)
202	('202',)
$670	('$670',)
451	('451',)
201	('201',)
361	('361',)
502	('502',)
invoic	('invoiced', 'invoicing')
$624\xa0	('$624\\xa0',)
49%	('49%',)
2022\xa0and	('2022\\xa0and',)
notion	('notional',)
non-design	('non-designated',)
441	('441',)
within\xa0eighteen	('within\\xa0eighteen',)
was\xa0not	('was\\xa0not',)
00\xa0	('00\\xa0',)
98\xa0billion	('98\\xa0billion',)
97\xa0billion	('97\\xa0billion',)
repaid	('repaid',)
00\xa0billion	('00\\xa0billion',)
unsecur	('unsecured',)
make-whol	('make-whole',)
09%	('09%',)
54%	('54%',)
963	('963',)
58\xa0billion	('58\\xa0billion',)
unpaid	('unpaid',)
30\xa0billion	('30\\xa0billion',)
uncondit	('unconditional',)
302	('302',)
765	('765',)
$670\xa0million	('$670\\xa0million',)
nine	('nine',)
$46	('$46',)
plaintiff	('plaintiffs',)
18-cv-07669-hsg	('18-cv-07669-hsg',)
district	('district',)
court	('court',)
re	('re',)
10b-5	('10b-5',)
sought	('sought',)
compensatori	('compensatory',)
attorney	('attorneys', 'attorney')
motion	('motion',)
ninth	('ninth',)
21-15604	('21-15604',)
oral	('oral',)
argument	('argument',)
19-cv-00341-hsg	('19-cv-00341-hsg',)
stay	('stayed', 'stay')
purportedli	('purportedly',)
unjust	('unjust',)
wast	('waste',)
allegedli	('allegedly',)
lipchitz	('lipchitz',)
et	('et',)
19-cv-01795-una	('19-cv-01795-una',)
nelson	('nelson',)
19-	('19-',)
cv-01798-	('cv-01798-',)
una	('una',)
year\xa0end	('year\\xa0ended',)
482	('482',)
161	('161',)
156	('156',)
446	('446',)
972	('972',)
926	('926',)
337	('337',)
289	('289',)
244	('244',)
798	('798',)
530	('530',)
gilti	('gilti',)
378	('378',)
709	('709',)
118	('118',)
315	('315',)
907	('907',)
978	('978',)
unremit	('unremitted',)
$806	('$806',)
$245	('$245',)
$241	('$241',)
$174	('$174',)
simplifi	('simplified',)
non-u	('non-u',)
eros	('erosion',)
re-valu	('re-valuing',)
$244\xa0million	('$244\\xa0million',)
$256\xa0million	('$256\\xa0million',)
undistribut	('undistributed',)
$153\xa0million	('$153\\xa0million',)
05\xa0billion	('05\\xa0billion',)
$232\xa0million	('$232\\xa0million',)
$907\xa0	('$907\\xa0',)
$728\xa0	('$728\\xa0',)
$397	('$397',)
$345	('$345',)
$341	('$341',)
$102	('$102',)
2042	('2042',)
$55\xa0million	('$55\\xa0million',)
authorit	('authoritative',)
deni	('denied', 'denies')
$808	('$808',)
$181	('$181',)
$138	('$138',)
583	('583',)
013	('013',)
$31	('$31',)
tax-rel	('tax-related',)
of\xa0	('of\\xa0',)
billion\xa0	('billion\\xa0',)
to\xa0$7	('to\\xa0$7',)
7\xa0million	('7\\xa0million',)
75\xa0billion	('75\\xa0billion',)
$395\xa0million	('$395\\xa0million',)
$390\xa0million	('$390\\xa0million',)
$20\xa0	('$20\\xa0',)
0\xa0	('0\\xa0',)
$120	('$120',)
$76	('$76',)
information\xa0	('information\\xa0',)
codm	('codm',)
interseg	('intersegment',)
548	('548',)
267	('267',)
step-	('step-',)
unalloc	('unallocated',)
531	('531',)
025	('025',)
886	('886',)
910	('910',)
044	('044',)
276	('276',)
represented\xa011%	('represented\\xa011%',)
represented\xa022%	('represented\\xa022%',)
16%\xa0of	('16%\\xa0of',)
of\xa0january\xa031	('of\\xa0january\\xa031',)
631	('631',)
505	('505',)
78	('78',)
643	('643',)
379	('379',)
balance\xa0at	('balance\\xa0at',)
doubt	('doubtful',)
562	('562',)
teal	('teal',)
barvaz	('barvaz',)
2^	('2^',)
1*	('1*',)
specimen	('specimen',)
s-1	('s-1',)
333-47495	('333-47495',)
fargo	('fargo',)
annex	('annex',)
7*	('7*',)
c-1	('c-1',)
d-1	('d-1',)
2+	('2+',)
3+	('3+',)
4+	('4+',)
5+	('5+',)
6+	('6+',)
non	('non',)
7+	('7+',)
8+	('8+',)
9+	('9+',)
10+	('10+',)
11+	('11+',)
12+	('12+',)
13+	('13+',)
14+	('14+',)
15+	('15+',)
16+*	('16+*',)
17+	('17+',)
18+	('18+',)
19+	('19+',)
20+	('20+',)
21+	('21+',)
22+	('22+',)
tim	('tim',)
23+	('23+',)
donald	('donald',)
dealer	('dealer',)
13a-14	('13a-14',)
2*	('2*',)
1#*	('1#*',)
2#*	('2#*',)
ins*	('ins*',)
xbrl	('xbrl',)
sch*	('sch*',)
taxonomi	('taxonomy',)
schema	('schema',)
cal*	('cal*',)
linkbas	('linkbase',)
def*	('def*',)
lab*	('lab*',)
label	('labels',)
pre*	('pre*',)
tag	('tags',)
inlin	('inline',)
*\xa0	('*\\xa0',)
+\xa0\xa0manag	('+\\xa0\\xa0management',)
#\xa0	('#\\xa0',)
601	('601',)
33-8238	('33-8238',)
34-47986	('34-47986',)
hereto	('hereto',)
section\xa018	('section\\xa018',)
^	('^',)
ca\xa095051	('ca\\xa095051',)
item\xa016	('item\\xa016',)
section\xa013	('section\\xa013',)
undersign	('undersigned',)
thereunto	('thereunto',)
huang\xa0	('huang\\xa0',)
attorney-in-fact	('attorney-in-fact',)
resubstitut	('resubstitution',)
stead	('stead',)
unto	('unto',)
said	('said',)
attorneys-in-fact	('attorneys-in-facts', 'attorneys-in-fact')
done	('done',)
confirm	('confirming', 'confirm')
kress\xa0	('kress\\xa0',)
president\xa0and\xa0chief	('president\\xa0and\\xa0chief',)
coxe\xa0\xa0	('coxe\\xa0\\xa0',)
coxe\xa0	('coxe\\xa0',)
jones\xa0	('jones\\xa0',)
perry\xa0	('perry\\xa0',)
seawell\xa0	('seawell\\xa0',)
stevens\xa0	('stevens\\xa0',)
chri	('chris',)
malachowski	('malachowsky',)
jay	('jay',)
almaden	('almaden',)
1800	('1800',)
95110	('95110',)
3175	('3175',)
hanov	('hanover',)
palo	('palo',)
alto	('alto',)
94304	('94304',)
registrar	('registrar',)
505000	('505000',)
louisvil	('louisville',)
kentucki	('kentucky',)
40233-5005	('40233-5005',)
pdt	('pdt',)
virtualsharehold	('virtualshareholder',)
corporation\u2003	('corporation\\u2003',)
\u2003	('\\u2003',)
95051\u2003	('95051\\u2003',)
big	('big',)
moment	('moment',)
here	('here',)
engadget	('engadget',)
cant	('cant',)
ignit	('ignited',)
bang	('bang',)
iphon	('iphone',)
bloomberg	('bloomberg',)
realist	('realistic',)
4080	('4080',)
superpod	('superpods', 'superpod')
4080-class	('4080-class',)
instantli	('instantly',)
browser	('browser',)
digital-to-phys	('digital-to-physical',)
model-mak	('model-making',)
tap	('tap',)
$250	('$250',)
jump	('jumping',)
novel	('novel',)
molecul	('molecules',)
protein-bas	('protein-based',)
medicin	('medicines', 'medicine')
state-of-the-art	('state-of-the-art',)
siliconangl	('siliconangle',)
layout	('layouts',)
mercedes-	('mercedes-',)
cabin	('cabins',)
culitho	('culitho',)
lithographi	('lithography',)
supercharg	('supercharges',)
immens	('immense', 'immensely')
tsmc	('tsmc',)
asml	('asml',)
pave	('paves',)
2nm	('2nm',)
headwind	('headwinds',)
swung	('swung',)
rose	('rose',)
skyrocket	('skyrocket',)
four-	('four-',)
decade-long	('decade-long',)
exponenti	('exponential',)
cpu-	('cpu-',)
general-purpos	('general-purpose',)
heard	('heard',)
showcas	('showcased',)
sens	('sense',)
reimagin	('reimagine',)
pharmaceut	('pharmaceutical',)
\u2026	('\\u2026',)
easi	('easy',)
particl	('particle',)
cuda-	('cuda-',)
speedup	('speedups', 'speedup')
flat	('flat',)
-8	('-8',)
-55%	('-55%',)
mask	('mask',)
overnight	('overnight',)
that	('thats',)
importantli	('importantly',)
miracl	('miracle',)
near	('near',)
high-numer	('high-numerical',)
apertur	('aperture',)
ultraviolet	('ultraviolet',)
radic	('radical',)
invers	('inverse',)
1-2%	('1-2%',)
bend	('bending',)
trendlin	('trendline',)
runaway	('runaway',)
storm	('storm', 'storms')
captiv	('captivated',)
vast	('vast',)
human-lik	('human-like',)
contextu	('contextually',)
nuanc	('nuances',)
grammar	('grammar',)
syntax	('syntax',)
distinguish	('distinguish',)
nlp	('nlp',)
music	('music',)
neuron	('neurons',)
byte	('bytes',)
unison	('unison',)
converg	('convergence',)
realm	('realm',)
narrow	('narrowed',)
simple-to-us	('simple-to-use',)
plain	('plain',)
seemingli	('seemingly',)
remark	('remarkable',)
eas	('ease',)
fastest-grow	('fastest-growing',)
what	('whats',)
rigor	('rigorous',)
trustworthi	('trustworthiness', 'trustworthy')
factual	('factual',)
guardrail	('guardrails',)
well-regard	('well-regarded',)
prolifer	('proliferating', 'proliferation')
10-15	('10-15',)
early-stag	('early-stage',)
amgen	('amgen',)
astrazeneca	('astrazeneca',)
insilico	('insilico',)
evozyn	('evozyne',)
innophor	('innophore',)
alchemab	('alchemab',)
early-access	('early-access',)
insati	('insatiable',)
zero-billion-dollar	('zero-billion-dollar',)
math	('math',)
prowess	('prowess',)
circl	('circle',)
shader	('shaders',)
pixel	('pixels',)
4x	('4x',)
pixel-predict	('pixel-prediction',)
reflex	('reflex',)
100+	('100+',)
10-year	('10-year',)
halo	('halo',)
minecraft	('minecraft',)
elder	('elder',)
scroll	('scrolls',)
bethesda	('bethesda',)
mojang	('mojang',)
activis	('activision',)
closur	('closure', 'closures')
life-sav	('life-saving',)
ground	('grounded',)
easier	('easier',)
onedr	('onedrive',)
sharepoint	('sharepoint',)
iot	('iot',)
last-minut	('last-minute',)
surpris	('surprises',)
\u203a	('\\u203a',)
scenario	('scenarios',)
epicent	('epicenter',)
reclaim	('reclaim',)
impossible-	('impossible-',)
to-solv	('to-solve',)
model-	('model-',)
magnific	('magnificent',)
nvda2023	('nvda2023',)
frequenc	('frequency',)
cr	('cr',)
erm	('erm',)
rba	('rba', 'rbas')
$27	('$27',)
other*	('other*',)
36%	('36%',)
\u25e6	('\\u25e6',)
groundbreak	('groundbreaking',)
enterprise-level	('enterprise-level',)
instant	('instant',)
*repres	('*represents',)
$203	('$203',)
pool	('pool',)
self	('self',)
record-level	('record-level',)
$38	('$38',)
99th	('99th',)
say-on-frequ	('say-on-frequency',)
stockholder-	('stockholder-',)
129	('129',)
295	('295',)
564	('564',)
648	('648',)
non-discretionari	('non-discretionary',)
14a-8	('14a-8',)
120th	('120th',)
apart	('apart',)
benton\xa0	('benton\\xa0',)
francisco-	('francisco-',)
entrepreneur-in-resid	('entrepreneur-in-residence',)
robust	('robust',)
latter	('latter',)
conven	('convening',)
themself	('themself',)
preapprov	('preapproval',)
formerli	('formerly',)
belong	('belonging',)
thorough	('thorough',)
escal	('escalation',)
staf	('staffed',)
proactiv	('proactively',)
overseen	('overseen',)
short-	('short-',)
intermediate-	('intermediate-',)
board-level	('board-level',)
stewardship	('stewardship',)
geographi	('geographies',)
on-campu	('on-campus',)
life-long	('life-long',)
self-learn	('self-learning',)
in-	('in-',)
tend	('tend',)
emb	('embed',)
equit	('equitable',)
pariti	('parity',)
men	('men',)
home-focus	('home-focused',)
unplug	('unplugs',)
safeguard	('safeguards', 'safeguarding')
cross-funct	('cross-functional',)
monthli	('monthly',)
uphold	('uphold', 'upholding')
freedom	('freedoms',)
compact	('compact',)
convent	('conventions', 'conventional')
labour	('labour',)
codifi	('codified',)
gold	('gold',)
tantalum	('tantalum',)
tungsten	('tungsten',)
tin	('tin',)
conflict-fre	('conflict-free',)
root	('rooted',)
profound	('profound',)
slightli	('slightly',)
$187	('$187',)
287	('287',)
$130	('$130',)
403	('403',)
278	('278',)
998	('998',)
435	('435',)
579	('579',)
481	('481',)
693	('693',)
\xa060	('\\xa060',)
02	('02',)
december\xa0	('december\\xa0',)
673	('673',)
december\xa030	('december\\xa030',)
fell	('fell',)
alongsid	('alongside',)
226%	('226%',)
238%	('238%',)
189%	('189%',)
jan	('jan',)
netflix	('netflix',)
visa	('visa',)
adb	('adbe',)
orcl	('orcl',)
intc	('intc',)
pypl	('pypl',)
txn	('txn',)
avgo	('avgo',)
intu	('intu',)
qcom	('qcom',)
csco	('csco',)
nflx	('nflx',)
crm	('crm',)
vmw	('vmw',)
$218	('$218',)
$24	('$24',)
$781	('$781',)
18%	('18%',)
inquir	('inquired',)
evenli	('evenly',)
shorter-term	('shorter-term',)
counterpart	('counterpart', 'counterparts')
chart	('charts',)
illustr	('illustrate',)
=	('=',)
626%	('626%',)
unchang	('unchanged',)
879	('879',)
939	('939',)
811	('811',)
23%	('23%',)
539	('539',)
319	('319',)
545	('545',)
701	('701',)
937	('937',)
159	('159',)
887	('887',)
895	('895',)
594	('594',)
894	('894',)
854	('854',)
807	('807',)
849	('849',)
458	('458',)
623	('623',)
residenti	('residential',)
rulemak	('rulemaking',)
666	('666',)
382	('382',)
917	('917',)
633	('633',)
991	('991',)
627	('627',)
698	('698',)
465	('465',)
142	('142',)
299	('299',)
498	('498',)
554	('554',)
901	('901',)
board-establish	('board-established',)
$565	('$565',)
305	('305',)
$90	('$90',)
217	('217',)
206	('206',)
$37	('$37',)
763	('763',)
571	('571',)
062	('062',)
059	('059',)
386	('386',)
589	('589',)
277	('277',)
528	('528',)
567	('567',)
817	('817',)
085	('085',)
541	('541',)
209	('209',)
659	('659',)
469	('469',)
168	('168',)
663	('663',)
824	('824',)
254	('254',)
076	('076',)
658	('658',)
392	('392',)
414	('414',)
795	('795',)
428	('428',)
083	('083',)
089	('089',)
928	('928',)
779	('779',)
229	('229',)
january\xa027	('january\\xa027',)
513	('513',)
286	('286',)
146	('146',)
573	('573',)
436	('436',)
009	('009',)
730	('730',)
370	('370',)
657	('657',)
127	('127',)
773	('773',)
072	('072',)
838	('838',)
078	('078',)
94	('94',)
prescrib	('prescribed',)
compensation-set	('compensation-setting',)
tabular	('tabular',)
non-ceo	('non-ceo',)
364	('364',)
09	('09',)
368	('368',)
543	('543',)
802	('802',)
453	('453',)
071	('071',)
875	('875',)
018	('018',)
686	('686',)
466	('466',)
262	('262',)
274	('274',)
599	('599',)
713	('713',)
644	('644',)
577	('577',)
460	('460',)
723	('723',)
company-select	('company-selected',)
unrank	('unranked',)
nasdaq100	('nasdaq100',)
formul	('formulating',)
fiscal\xa02023	('fiscal\\xa02023',)
defens	('defense',)
available\xa0for	('available\\xa0for',)
167	('167',)
389	('389',)
291	('291',)
230	('230',)
273	('273',)
092	('092',)
877	('877',)
incentive-bas	('incentive-based',)
\xa7240	('\\xa7240',)
10d-1	('10d-1',)
july\xa029	('july\\xa029',)
$434	('$434',)
february\xa017	('february\\xa017',)
47\xa0billion	('47\\xa0billion',)
[reserved]	('[reserved]',)
characterist	('characteristics',)
audio	('audio',)
end-	('end-',)
high-precis	('high-precision',)
hopper-	('hopper-',)
flagship	('flagship',)
customiz	('customizable',)
span	('spanning',)
data-center-infrastructure-on-a-chip	('data-center-infrastructure-on-a-chip',)
twice	('twice',)
system-on-chip	('system-on-chips',)
post-product	('post-production',)
ai-bas	('ai-based',)
re-	('re-',)
redund	('redundancy',)
resili	('resilience',)
chroma	('chroma',)
ate	('ate',)
macau	('macau',)
quantifi	('quantify',)
factors-	('factors-',)
surfac	('surface',)
37%	('37%',)
shepherd	('shepherd',)
\xa0contain	('\\xa0contains',)
stem	('stems',)
software-	('software-',)
infrastructure-	('infrastructure-',)
monet	('monetize',)
as-a-	('as-a-',)
mention	('mentioned',)
imped	('impeded',)
overestim	('overestimate', 'overestimation')
lockdown	('lockdowns', 'lockdown')
ai-rel	('ai-related',)
misalign	('misaligned',)
downstream	('downstream',)
lead-	('lead-',)
cost-	('cost-',)
placement	('placement',)
non-return	('non-returnable',)
exacerb	('exacerbated', 'exacerbate')
drop	('drops',)
marketplac	('marketplaces',)
conserv	('conservation',)
withdraw	('withdrawal',)
69%	('69%',)
counter-	('counter-',)
proprieti	('propriety',)
gfn	('gfn',)
interchang	('interchange',)
covid-19-rel	('covid-19-related',)
reinstat	('reinstated',)
resurfac	('resurfaces',)
belaru	('belarus',)
emea	('emea',)
unilater	('unilateral',)
multilater	('multilateral',)
wareh	('warehousing',)
disadvantag	('disadvantage',)
oversea	('overseas',)
provok	('provoke',)
usg	('usg',)
a100x	('a100x',)
peak	('peak',)
chip-to-chip	('chip-to-chip',)
destin	('destined',)
a800	('a800',)
disproportion	('disproportionate', 'disproportionately')
complic	('complicated',)
burdensom	('burdensome',)
pre-sal	('pre-sale',)
post-sal	('post-sale',)
cumbersom	('cumbersome',)
unintend	('unintended',)
utah	('utah',)
connecticut	('connecticut',)
bilater	('bilateral',)
overturn	('overturned',)
union-unit	('union-united',)
cyberspac	('cyberspace',)
cac	('cac',)
bound	('bound',)
sometim	('sometimes',)
self-regulatori	('self-regulatory',)
unfair	('unfair',)
misrepres	('misrepresentative',)
undergo	('undergoing',)
excis	('excise',)
preferenti	('preferential',)
fdii	('fdii',)
undertaken	('undertaken',)
co-oper	('co-operation',)
3\xa0million	('3\\xa0million',)
approximately\xa0344	('approximately\\xa0344',)
63\xa0million	('63\\xa0million',)
04\xa0billion	('04\\xa0billion',)
10b5-1	('10b5-1',)
paid\xa0	('paid\\xa0',)
$398	('$398',)
million\xa0	('million\\xa0',)
213	('213',)
181	('181',)
as-a-servic	('as-a-service',)
sell-in	('sell-in',)
macro-econom	('macro-economic',)
weigh	('weighed',)
44\xa0billion	('44\\xa0billion',)
undership	('undershipping',)
4090	('4090',)
4070	('4070',)
grew	('grew',)
first-	('first-',)
48\xa0billion	('48\\xa0billion',)
$133\xa0million	('$133\\xa0million',)
march\xa018	('march\\xa018',)
022	('022',)
906	('906',)
for\xa069%	('for\\xa069%',)
years\xa02023	('years\\xa02023',)
$137	('$137',)
mark-to-market	('mark-to-market',)
mandatori	('mandatory',)
617	('617',)
non-cash	('non-cash',)
953	('953',)
703	('703',)
$95	('$95',)
\xa0gain	('\\xa0gains',)
shekel	('shekel',)
$112	('$112',)
$36	('$36',)
-\xa0	('-\\xa0',)
framewor	('framewor',)
february\xa024	('february\\xa024',)
618	('618',)
336	('336',)
073	('073',)
372	('372',)
820	('820',)
182	('182',)
563	('563',)
398	('398',)
517	('517',)
341	('341',)
available-	('available-',)
for-sal	('for-sale',)
cash-flow	('cash-flow',)
our\xa0	('our\\xa0',)
we\xa0	('we\\xa0',)
13\xa0billion	('13\\xa0billion',)
56\xa0million	('56\\xa0million',)
249\xa0thousand	('249\\xa0thousand',)
220	('220',)
198	('198',)
180	('180',)
2029	('2029',)
$463\xa0million	('$463\\xa0million',)
$193	('$193',)
%-4	('%-4',)
43%-72%	('43%-72%',)
2\xa0million	('2\\xa0million',)
\xa0curr	('\\xa0currently',)
230\xa0million	('230\\xa0million',)
of\xa0january\xa029	('of\\xa0january\\xa029',)
2023\xa0and\xa0january\xa030	('2023\\xa0and\\xa0january\\xa030',)
$410\xa0million	('$410\\xa0million',)
$642\xa0million	('$642\\xa0million',)
27\xa0billion	('27\\xa0billion',)
37\xa0billion	('37\\xa0billion',)
$370\xa0	('$370\\xa0',)
$23\xa0million	('$23\\xa0million',)
$14\xa0million	('$14\\xa0million',)
$9\xa0	('$9\\xa0',)
$699	('$699',)
$602	('$602',)
$541	('$541',)
$247	('$247',)
$142	('$142',)
$35	('$35',)
$109	('$109',)
797	('797',)
087	('087',)
884	('884',)
738	('738',)
870	('870',)
$61\xa0million	('$61\\xa0million',)
430	('430',)
$173\xa0million	('$173\\xa0million',)
694	('694',)
$844	('$844',)
$327	('$327',)
$374\xa0million	('$374\\xa0million',)
387	('387',)
954	('954',)
354	('354',)
443	('443',)
$181\xa0million	('$181\\xa0million',)
underutil	('underutilization',)
247	('247',)
$652\xa0million	('$652\\xa0million',)
2023\xa0and	('2023\\xa0and',)
of\xa0january\xa0	('of\\xa0january\\xa0',)
non-financi	('non-financial',)
$810\xa0	('$810\\xa0',)
92\xa0billion	('92\\xa0billion',)
$810\xa0million	('$810\\xa0million',)
non-inventori	('non-inventory',)
14\xa0billion	('14\\xa0billion',)
23\xa0billion	('23\\xa0billion',)
679	('679',)
622	('622',)
253	('253',)
063	('063',)
$82	('$82',)
$122\xa0million	('$122\\xa0million',)
warranty-rel	('warranty-related',)
$70\xa0million	('$70\\xa0million',)
technology-rel	('technology-related',)
261	('261',)
951	('951',)
522	('522',)
22\xa0billion	('22\\xa0billion',)
$245\xa0million	('$245\\xa0million',)
05\xa0	('05\\xa0',)
$245\xa0	('$245\\xa0',)
$363	('$363',)
$329	('$329',)
$83\xa0	('$83\\xa0',)
$770\xa0million	('$770\\xa0million',)
$33\xa0million	('$33\\xa0million',)
$7\xa0million	('$7\\xa0million',)
$95\xa0million	('$95\\xa0million',)
$59\xa0million	('$59\\xa0million',)
of\xa0$17	('of\\xa0$17',)
additional\xa0$7	('additional\\xa0$7',)
$399\xa0million	('$399\\xa0million',)
0\xa0billion	('0\\xa0billion',)
$227	('$227',)
recur	('recurring',)
balance\xa0a	('balance\\xa0as',)
702	('702',)
6*	('6*',)
2+*	('2+*',)
14+*	('14+*',)
16+	('16+',)
43006	('43006',)
ri	('ri',)
02940-3006	('02940-3006',)
\u20032788	('\\u20032788',)
\u2003www	('\\u2003www',)
