probability	{'Probability Theory': 3, "Bayes' Theorem": 2, 'Statistical Inference': 1, 'Descriptive Statistics': 1, 'Gaussian Distribution': 1, 'Bell Curve': 1, 'Bayesian Statistics': 1}
measure	{'Probability Theory': 1, "Bayes' Theorem": 1}
probability~measure	{'Probability Theory': 1, "Bayes' Theorem": 1}
likelihood	{'Probability Theory': 1, "Bayes' Theorem": 1}
measure~likelihood	{'Probability Theory': 1, "Bayes' Theorem": 1}
probability~measure~likelihood	{'Probability Theory': 1, "Bayes' Theorem": 1}
event	{'Probability Theory': 5, "Bayes' Theorem": 3, 'Bayesian Statistics': 2}
likelihood~event	{'Probability Theory': 1, "Bayes' Theorem": 1}
measure~likelihood~event	{'Probability Theory': 1, "Bayes' Theorem": 1}
occurring	{'Probability Theory': 1, "Bayes' Theorem": 1}
event~occurring	{'Probability Theory': 1, "Bayes' Theorem": 1}
likelihood~event~occurring	{'Probability Theory': 1, "Bayes' Theorem": 1}
it	{'Probability Theory': 3, "Bayes' Theorem": 2, 'Gaussian Distribution': 1, 'Bell Curve': 1, 'Bayesian Statistics': 1, 'Big Data': 1, 'Data Mining': 1, 'Predictive Analytics': 1}
occurring~it	{'Probability Theory': 1, "Bayes' Theorem": 1}
event~occurring~it	{'Probability Theory': 1, "Bayes' Theorem": 1}
quantified	{'Probability Theory': 1, "Bayes' Theorem": 1}
it~quantified	{'Probability Theory': 1, "Bayes' Theorem": 1}
occurring~it~quantified	{'Probability Theory': 1, "Bayes' Theorem": 1}
as	{'Probability Theory': 1, "Bayes' Theorem": 1}
quantified~as	{'Probability Theory': 1, "Bayes' Theorem": 1}
it~quantified~as	{'Probability Theory': 1, "Bayes' Theorem": 1}
number	{'Probability Theory': 1, "Bayes' Theorem": 1}
as~number	{'Probability Theory': 1, "Bayes' Theorem": 1}
quantified~as~number	{'Probability Theory': 1, "Bayes' Theorem": 1}
between	{'Probability Theory': 1, "Bayes' Theorem": 1}
number~between	{'Probability Theory': 1, "Bayes' Theorem": 1}
as~number~between	{'Probability Theory': 1, "Bayes' Theorem": 1}
0	{'Probability Theory': 2, "Bayes' Theorem": 2}
between~0	{'Probability Theory': 1, "Bayes' Theorem": 1}
number~between~0	{'Probability Theory': 1, "Bayes' Theorem": 1}
1	{'Probability Theory': 2, "Bayes' Theorem": 2}
0~1	{'Probability Theory': 1, "Bayes' Theorem": 1}
between~0~1	{'Probability Theory': 1, "Bayes' Theorem": 1}
where	{'Probability Theory': 1, "Bayes' Theorem": 1}
1~where	{'Probability Theory': 1, "Bayes' Theorem": 1}
0~1~where	{'Probability Theory': 1, "Bayes' Theorem": 1}
where~0	{'Probability Theory': 1, "Bayes' Theorem": 1}
1~where~0	{'Probability Theory': 1, "Bayes' Theorem": 1}
indicates	{'Probability Theory': 2, "Bayes' Theorem": 2}
0~indicates	{'Probability Theory': 1, "Bayes' Theorem": 1}
where~0~indicates	{'Probability Theory': 1, "Bayes' Theorem": 1}
impossibility	{'Probability Theory': 1, "Bayes' Theorem": 1}
indicates~impossibility	{'Probability Theory': 1, "Bayes' Theorem": 1}
0~indicates~impossibility	{'Probability Theory': 1, "Bayes' Theorem": 1}
impossibility~1	{'Probability Theory': 1, "Bayes' Theorem": 1}
indicates~impossibility~1	{'Probability Theory': 1, "Bayes' Theorem": 1}
1~indicates	{'Probability Theory': 1, "Bayes' Theorem": 1}
impossibility~1~indicates	{'Probability Theory': 1, "Bayes' Theorem": 1}
certainty	{'Probability Theory': 1, "Bayes' Theorem": 1}
indicates~certainty	{'Probability Theory': 1, "Bayes' Theorem": 1}
1~indicates~certainty	{'Probability Theory': 1, "Bayes' Theorem": 1}
higher	{'Probability Theory': 1, "Bayes' Theorem": 1}
certainty~higher	{'Probability Theory': 1, "Bayes' Theorem": 1}
indicates~certainty~higher	{'Probability Theory': 1, "Bayes' Theorem": 1}
higher~probability	{'Probability Theory': 1, "Bayes' Theorem": 1}
certainty~higher~probability	{'Probability Theory': 1, "Bayes' Theorem": 1}
probability~event	{'Probability Theory': 2, "Bayes' Theorem": 1, 'Bayesian Statistics': 1}
higher~probability~event	{'Probability Theory': 1, "Bayes' Theorem": 1}
more	{'Probability Theory': 1, "Bayes' Theorem": 1}
event~more	{'Probability Theory': 1, "Bayes' Theorem": 1}
probability~event~more	{'Probability Theory': 1, "Bayes' Theorem": 1}
likely	{'Probability Theory': 1, "Bayes' Theorem": 1}
more~likely	{'Probability Theory': 1, "Bayes' Theorem": 1}
event~more~likely	{'Probability Theory': 1, "Bayes' Theorem": 1}
likely~it	{'Probability Theory': 1, "Bayes' Theorem": 1}
more~likely~it	{'Probability Theory': 1, "Bayes' Theorem": 1}
that	{'Probability Theory': 2, "Bayes' Theorem": 1, 'Statistical Inference': 1, 'Descriptive Statistics': 1, 'Bayesian Statistics': 1, 'Big Data': 1, 'Data Mining': 1, 'Predictive Analytics': 1}
it~that	{'Probability Theory': 1, "Bayes' Theorem": 1}
likely~it~that	{'Probability Theory': 1, "Bayes' Theorem": 1}
that~event	{'Probability Theory': 1, "Bayes' Theorem": 1}
it~that~event	{'Probability Theory': 1, "Bayes' Theorem": 1}
will	{'Probability Theory': 1, "Bayes' Theorem": 1}
event~will	{'Probability Theory': 1, "Bayes' Theorem": 1}
that~event~will	{'Probability Theory': 1, "Bayes' Theorem": 1}
occur	{'Probability Theory': 1, "Bayes' Theorem": 1}
will~occur	{'Probability Theory': 1, "Bayes' Theorem": 1}
event~will~occur	{'Probability Theory': 1, "Bayes' Theorem": 1}
statistics	{'Statistical Inference': 1, 'Descriptive Statistics': 1, 'Gaussian Distribution': 1, 'Bell Curve': 1, 'Bayesian Statistics': 1, 'Probability Theory': 1, 'Big Data': 1, 'Data Mining': 1, 'Predictive Analytics': 1}
discipline	{'Statistical Inference': 1, 'Descriptive Statistics': 1}
statistics~discipline	{'Statistical Inference': 1, 'Descriptive Statistics': 1}
discipline~that	{'Statistical Inference': 1, 'Descriptive Statistics': 1}
statistics~discipline~that	{'Statistical Inference': 1, 'Descriptive Statistics': 1}
concerns	{'Statistical Inference': 1, 'Descriptive Statistics': 1}
that~concerns	{'Statistical Inference': 1, 'Descriptive Statistics': 1}
discipline~that~concerns	{'Statistical Inference': 1, 'Descriptive Statistics': 1}
collection	{'Statistical Inference': 1, 'Descriptive Statistics': 1}
concerns~collection	{'Statistical Inference': 1, 'Descriptive Statistics': 1}
that~concerns~collection	{'Statistical Inference': 1, 'Descriptive Statistics': 1}
organization	{'Statistical Inference': 1, 'Descriptive Statistics': 1}
collection~organization	{'Statistical Inference': 1, 'Descriptive Statistics': 1}
concerns~collection~organization	{'Statistical Inference': 1, 'Descriptive Statistics': 1}
analysis	{'Statistical Inference': 2, 'Descriptive Statistics': 2}
organization~analysis	{'Statistical Inference': 1, 'Descriptive Statistics': 1}
collection~organization~analysis	{'Statistical Inference': 1, 'Descriptive Statistics': 1}
interpretation	{'Statistical Inference': 1, 'Descriptive Statistics': 1}
analysis~interpretation	{'Statistical Inference': 1, 'Descriptive Statistics': 1}
organization~analysis~interpretation	{'Statistical Inference': 1, 'Descriptive Statistics': 1}
presentation	{'Statistical Inference': 1, 'Descriptive Statistics': 1}
interpretation~presentation	{'Statistical Inference': 1, 'Descriptive Statistics': 1}
analysis~interpretation~presentation	{'Statistical Inference': 1, 'Descriptive Statistics': 1}
data	{'Statistical Inference': 2, 'Descriptive Statistics': 2, 'Big Data': 2, 'Data Mining': 2, 'Predictive Analytics': 2}
presentation~data	{'Statistical Inference': 1, 'Descriptive Statistics': 1}
interpretation~presentation~data	{'Statistical Inference': 1, 'Descriptive Statistics': 1}
statistical	{'Statistical Inference': 1, 'Descriptive Statistics': 1}
data~statistical	{'Statistical Inference': 1, 'Descriptive Statistics': 1}
presentation~data~statistical	{'Statistical Inference': 1, 'Descriptive Statistics': 1}
statistical~analysis	{'Statistical Inference': 1, 'Descriptive Statistics': 1}
data~statistical~analysis	{'Statistical Inference': 1, 'Descriptive Statistics': 1}
often	{'Statistical Inference': 1, 'Descriptive Statistics': 1, 'Gaussian Distribution': 1, 'Bell Curve': 1}
analysis~often	{'Statistical Inference': 1, 'Descriptive Statistics': 1}
statistical~analysis~often	{'Statistical Inference': 1, 'Descriptive Statistics': 1}
uses	{'Statistical Inference': 1, 'Descriptive Statistics': 1, 'Big Data': 1, 'Data Mining': 1, 'Predictive Analytics': 1}
often~uses	{'Statistical Inference': 1, 'Descriptive Statistics': 1}
analysis~often~uses	{'Statistical Inference': 1, 'Descriptive Statistics': 1}
uses~probability	{'Statistical Inference': 1, 'Descriptive Statistics': 1}
often~uses~probability	{'Statistical Inference': 1, 'Descriptive Statistics': 1}
theory	{'Statistical Inference': 1, 'Descriptive Statistics': 1}
probability~theory	{'Statistical Inference': 1, 'Descriptive Statistics': 1}
uses~probability~theory	{'Statistical Inference': 1, 'Descriptive Statistics': 1}
essential	{'Statistical Inference': 1, 'Descriptive Statistics': 1}
theory~essential	{'Statistical Inference': 1, 'Descriptive Statistics': 1}
probability~theory~essential	{'Statistical Inference': 1, 'Descriptive Statistics': 1}
essential~data	{'Statistical Inference': 1, 'Descriptive Statistics': 1}
theory~essential~data	{'Statistical Inference': 1, 'Descriptive Statistics': 1}
science	{'Statistical Inference': 1, 'Descriptive Statistics': 1, 'Big Data': 3, 'Data Mining': 3, 'Predictive Analytics': 3}
data~science	{'Statistical Inference': 1, 'Descriptive Statistics': 1, 'Big Data': 1, 'Data Mining': 1, 'Predictive Analytics': 1}
essential~data~science	{'Statistical Inference': 1, 'Descriptive Statistics': 1}
normal	{'Gaussian Distribution': 2, 'Bell Curve': 2}
distribution	{'Gaussian Distribution': 4, 'Bell Curve': 4}
normal~distribution	{'Gaussian Distribution': 2, 'Bell Curve': 2}
continuous	{'Gaussian Distribution': 1, 'Bell Curve': 1}
distribution~continuous	{'Gaussian Distribution': 1, 'Bell Curve': 1}
normal~distribution~continuous	{'Gaussian Distribution': 1, 'Bell Curve': 1}
continuous~probability	{'Gaussian Distribution': 1, 'Bell Curve': 1}
distribution~continuous~probability	{'Gaussian Distribution': 1, 'Bell Curve': 1}
probability~distribution	{'Gaussian Distribution': 1, 'Bell Curve': 1}
continuous~probability~distribution	{'Gaussian Distribution': 1, 'Bell Curve': 1}
distribution~it	{'Gaussian Distribution': 1, 'Bell Curve': 1}
probability~distribution~it	{'Gaussian Distribution': 1, 'Bell Curve': 1}
also	{'Gaussian Distribution': 1, 'Bell Curve': 1}
it~also	{'Gaussian Distribution': 1, 'Bell Curve': 1}
distribution~it~also	{'Gaussian Distribution': 1, 'Bell Curve': 1}
called	{'Gaussian Distribution': 1, 'Bell Curve': 1}
also~called	{'Gaussian Distribution': 1, 'Bell Curve': 1}
it~also~called	{'Gaussian Distribution': 1, 'Bell Curve': 1}
gaussian	{'Gaussian Distribution': 1, 'Bell Curve': 1}
called~gaussian	{'Gaussian Distribution': 1, 'Bell Curve': 1}
also~called~gaussian	{'Gaussian Distribution': 1, 'Bell Curve': 1}
gaussian~distribution	{'Gaussian Distribution': 1, 'Bell Curve': 1}
called~gaussian~distribution	{'Gaussian Distribution': 1, 'Bell Curve': 1}
distribution~normal	{'Gaussian Distribution': 1, 'Bell Curve': 1}
gaussian~distribution~normal	{'Gaussian Distribution': 1, 'Bell Curve': 1}
distribution~normal~distribution	{'Gaussian Distribution': 1, 'Bell Curve': 1}
important	{'Gaussian Distribution': 1, 'Bell Curve': 1}
distribution~important	{'Gaussian Distribution': 1, 'Bell Curve': 1}
normal~distribution~important	{'Gaussian Distribution': 1, 'Bell Curve': 1}
important~statistics	{'Gaussian Distribution': 1, 'Bell Curve': 1}
distribution~important~statistics	{'Gaussian Distribution': 1, 'Bell Curve': 1}
statistics~often	{'Gaussian Distribution': 1, 'Bell Curve': 1}
important~statistics~often	{'Gaussian Distribution': 1, 'Bell Curve': 1}
used	{'Gaussian Distribution': 1, 'Bell Curve': 1}
often~used	{'Gaussian Distribution': 1, 'Bell Curve': 1}
statistics~often~used	{'Gaussian Distribution': 1, 'Bell Curve': 1}
natural	{'Gaussian Distribution': 1, 'Bell Curve': 1}
used~natural	{'Gaussian Distribution': 1, 'Bell Curve': 1}
often~used~natural	{'Gaussian Distribution': 1, 'Bell Curve': 1}
social	{'Gaussian Distribution': 1, 'Bell Curve': 1}
natural~social	{'Gaussian Distribution': 1, 'Bell Curve': 1}
used~natural~social	{'Gaussian Distribution': 1, 'Bell Curve': 1}
sciences	{'Gaussian Distribution': 1, 'Bell Curve': 1}
social~sciences	{'Gaussian Distribution': 1, 'Bell Curve': 1}
natural~social~sciences	{'Gaussian Distribution': 1, 'Bell Curve': 1}
bayes	{'Bayesian Statistics': 1, 'Probability Theory': 1}
theorem	{'Bayesian Statistics': 1, 'Probability Theory': 1}
bayes~theorem	{'Bayesian Statistics': 1, 'Probability Theory': 1}
describes	{'Bayesian Statistics': 1, 'Probability Theory': 1}
theorem~describes	{'Bayesian Statistics': 1, 'Probability Theory': 1}
bayes~theorem~describes	{'Bayesian Statistics': 1, 'Probability Theory': 1}
describes~probability	{'Bayesian Statistics': 1, 'Probability Theory': 1}
theorem~describes~probability	{'Bayesian Statistics': 1, 'Probability Theory': 1}
describes~probability~event	{'Bayesian Statistics': 1, 'Probability Theory': 1}
based	{'Bayesian Statistics': 1, 'Probability Theory': 1}
event~based	{'Bayesian Statistics': 1, 'Probability Theory': 1}
probability~event~based	{'Bayesian Statistics': 1, 'Probability Theory': 1}
prior	{'Bayesian Statistics': 1, 'Probability Theory': 1}
based~prior	{'Bayesian Statistics': 1, 'Probability Theory': 1}
event~based~prior	{'Bayesian Statistics': 1, 'Probability Theory': 1}
knowledge	{'Bayesian Statistics': 1, 'Probability Theory': 1, 'Big Data': 1, 'Data Mining': 1, 'Predictive Analytics': 1}
prior~knowledge	{'Bayesian Statistics': 1, 'Probability Theory': 1}
based~prior~knowledge	{'Bayesian Statistics': 1, 'Probability Theory': 1}
conditions	{'Bayesian Statistics': 1, 'Probability Theory': 1}
knowledge~conditions	{'Bayesian Statistics': 1, 'Probability Theory': 1}
prior~knowledge~conditions	{'Bayesian Statistics': 1, 'Probability Theory': 1}
conditions~that	{'Bayesian Statistics': 1, 'Probability Theory': 1}
knowledge~conditions~that	{'Bayesian Statistics': 1, 'Probability Theory': 1}
might	{'Bayesian Statistics': 1, 'Probability Theory': 1}
that~might	{'Bayesian Statistics': 1, 'Probability Theory': 1}
conditions~that~might	{'Bayesian Statistics': 1, 'Probability Theory': 1}
related	{'Bayesian Statistics': 1, 'Probability Theory': 1}
might~related	{'Bayesian Statistics': 1, 'Probability Theory': 1}
that~might~related	{'Bayesian Statistics': 1, 'Probability Theory': 1}
related~event	{'Bayesian Statistics': 1, 'Probability Theory': 1}
might~related~event	{'Bayesian Statistics': 1, 'Probability Theory': 1}
event~it	{'Bayesian Statistics': 1, 'Probability Theory': 1}
related~event~it	{'Bayesian Statistics': 1, 'Probability Theory': 1}
fundamental	{'Bayesian Statistics': 1, 'Probability Theory': 1}
it~fundamental	{'Bayesian Statistics': 1, 'Probability Theory': 1}
event~it~fundamental	{'Bayesian Statistics': 1, 'Probability Theory': 1}
bayesian	{'Bayesian Statistics': 1, 'Probability Theory': 1}
fundamental~bayesian	{'Bayesian Statistics': 1, 'Probability Theory': 1}
it~fundamental~bayesian	{'Bayesian Statistics': 1, 'Probability Theory': 1}
bayesian~statistics	{'Bayesian Statistics': 1, 'Probability Theory': 1}
fundamental~bayesian~statistics	{'Bayesian Statistics': 1, 'Probability Theory': 1}
interdisciplinary	{'Big Data': 1, 'Data Mining': 1, 'Predictive Analytics': 1}
science~interdisciplinary	{'Big Data': 1, 'Data Mining': 1, 'Predictive Analytics': 1}
data~science~interdisciplinary	{'Big Data': 1, 'Data Mining': 1, 'Predictive Analytics': 1}
field	{'Big Data': 1, 'Data Mining': 1, 'Predictive Analytics': 1}
interdisciplinary~field	{'Big Data': 1, 'Data Mining': 1, 'Predictive Analytics': 1}
science~interdisciplinary~field	{'Big Data': 1, 'Data Mining': 1, 'Predictive Analytics': 1}
field~that	{'Big Data': 1, 'Data Mining': 1, 'Predictive Analytics': 1}
interdisciplinary~field~that	{'Big Data': 1, 'Data Mining': 1, 'Predictive Analytics': 1}
that~uses	{'Big Data': 1, 'Data Mining': 1, 'Predictive Analytics': 1}
field~that~uses	{'Big Data': 1, 'Data Mining': 1, 'Predictive Analytics': 1}
scientific	{'Big Data': 1, 'Data Mining': 1, 'Predictive Analytics': 1}
uses~scientific	{'Big Data': 1, 'Data Mining': 1, 'Predictive Analytics': 1}
that~uses~scientific	{'Big Data': 1, 'Data Mining': 1, 'Predictive Analytics': 1}
methods	{'Big Data': 1, 'Data Mining': 1, 'Predictive Analytics': 1}
scientific~methods	{'Big Data': 1, 'Data Mining': 1, 'Predictive Analytics': 1}
uses~scientific~methods	{'Big Data': 1, 'Data Mining': 1, 'Predictive Analytics': 1}
processes	{'Big Data': 1, 'Data Mining': 1, 'Predictive Analytics': 1}
methods~processes	{'Big Data': 1, 'Data Mining': 1, 'Predictive Analytics': 1}
scientific~methods~processes	{'Big Data': 1, 'Data Mining': 1, 'Predictive Analytics': 1}
algorithms	{'Big Data': 1, 'Data Mining': 1, 'Predictive Analytics': 1}
processes~algorithms	{'Big Data': 1, 'Data Mining': 1, 'Predictive Analytics': 1}
methods~processes~algorithms	{'Big Data': 1, 'Data Mining': 1, 'Predictive Analytics': 1}
systems	{'Big Data': 1, 'Data Mining': 1, 'Predictive Analytics': 1}
algorithms~systems	{'Big Data': 1, 'Data Mining': 1, 'Predictive Analytics': 1}
processes~algorithms~systems	{'Big Data': 1, 'Data Mining': 1, 'Predictive Analytics': 1}
extract	{'Big Data': 1, 'Data Mining': 1, 'Predictive Analytics': 1}
systems~extract	{'Big Data': 1, 'Data Mining': 1, 'Predictive Analytics': 1}
algorithms~systems~extract	{'Big Data': 1, 'Data Mining': 1, 'Predictive Analytics': 1}
extract~knowledge	{'Big Data': 1, 'Data Mining': 1, 'Predictive Analytics': 1}
systems~extract~knowledge	{'Big Data': 1, 'Data Mining': 1, 'Predictive Analytics': 1}
insights	{'Big Data': 1, 'Data Mining': 1, 'Predictive Analytics': 1}
knowledge~insights	{'Big Data': 1, 'Data Mining': 1, 'Predictive Analytics': 1}
extract~knowledge~insights	{'Big Data': 1, 'Data Mining': 1, 'Predictive Analytics': 1}
structured	{'Big Data': 1, 'Data Mining': 1, 'Predictive Analytics': 1}
insights~structured	{'Big Data': 1, 'Data Mining': 1, 'Predictive Analytics': 1}
knowledge~insights~structured	{'Big Data': 1, 'Data Mining': 1, 'Predictive Analytics': 1}
unstructured	{'Big Data': 1, 'Data Mining': 1, 'Predictive Analytics': 1}
structured~unstructured	{'Big Data': 1, 'Data Mining': 1, 'Predictive Analytics': 1}
insights~structured~unstructured	{'Big Data': 1, 'Data Mining': 1, 'Predictive Analytics': 1}
unstructured~data	{'Big Data': 1, 'Data Mining': 1, 'Predictive Analytics': 1}
structured~unstructured~data	{'Big Data': 1, 'Data Mining': 1, 'Predictive Analytics': 1}
data~it	{'Big Data': 1, 'Data Mining': 1, 'Predictive Analytics': 1}
unstructured~data~it	{'Big Data': 1, 'Data Mining': 1, 'Predictive Analytics': 1}
employs	{'Big Data': 1, 'Data Mining': 1, 'Predictive Analytics': 1}
it~employs	{'Big Data': 1, 'Data Mining': 1, 'Predictive Analytics': 1}
data~it~employs	{'Big Data': 1, 'Data Mining': 1, 'Predictive Analytics': 1}
techniques	{'Big Data': 1, 'Data Mining': 1, 'Predictive Analytics': 1}
employs~techniques	{'Big Data': 1, 'Data Mining': 1, 'Predictive Analytics': 1}
it~employs~techniques	{'Big Data': 1, 'Data Mining': 1, 'Predictive Analytics': 1}
techniques~statistics	{'Big Data': 1, 'Data Mining': 1, 'Predictive Analytics': 1}
employs~techniques~statistics	{'Big Data': 1, 'Data Mining': 1, 'Predictive Analytics': 1}
computer	{'Big Data': 1, 'Data Mining': 1, 'Predictive Analytics': 1}
statistics~computer	{'Big Data': 1, 'Data Mining': 1, 'Predictive Analytics': 1}
techniques~statistics~computer	{'Big Data': 1, 'Data Mining': 1, 'Predictive Analytics': 1}
computer~science	{'Big Data': 1, 'Data Mining': 1, 'Predictive Analytics': 1}
statistics~computer~science	{'Big Data': 1, 'Data Mining': 1, 'Predictive Analytics': 1}
information	{'Big Data': 1, 'Data Mining': 1, 'Predictive Analytics': 1}
science~information	{'Big Data': 1, 'Data Mining': 1, 'Predictive Analytics': 1}
computer~science~information	{'Big Data': 1, 'Data Mining': 1, 'Predictive Analytics': 1}
information~science	{'Big Data': 1, 'Data Mining': 1, 'Predictive Analytics': 1}
science~information~science	{'Big Data': 1, 'Data Mining': 1, 'Predictive Analytics': 1}
