probability	{'measure': 1, 'higher': 1, 'event': 2, 'uses': 1, 'theory': 1, 'continuous': 1, 'distribution': 1, 'describes': 1}
measure	{'probability': 1, 'likelihood': 1}
likelihood	{'measure': 1, 'event': 1}
event	{'likelihood': 1, 'occurring': 1, 'probability': 2, 'more': 1, 'that': 1, 'will': 1, 'based': 1, 'related': 1, 'it': 1}
occurring	{'event': 1, 'it': 1}
it	{'occurring': 1, 'quantified': 1, 'likely': 1, 'that': 1, 'distribution': 1, 'also': 1, 'event': 1, 'fundamental': 1, 'data': 1, 'employs': 1}
quantified	{'it': 1, 'as': 1}
as	{'quantified': 1, 'number': 1}
number	{'as': 1, 'between': 1}
between	{'number': 1, '0': 1}
0	{'between': 1, '1': 1, 'where': 1, 'indicates': 1}
1	{'0': 1, 'where': 1, 'impossibility': 1, 'indicates': 1}
where	{'1': 1, '0': 1}
indicates	{'0': 1, 'impossibility': 1, '1': 1, 'certainty': 1}
impossibility	{'indicates': 1, '1': 1}
certainty	{'indicates': 1, 'higher': 1}
higher	{'certainty': 1, 'probability': 1}
more	{'event': 1, 'likely': 1}
likely	{'more': 1, 'it': 1}
that	{'it': 1, 'event': 1, 'discipline': 1, 'concerns': 1, 'conditions': 1, 'might': 1, 'field': 1, 'uses': 1}
will	{'event': 1, 'occur': 1}
occur	{'will': 1}
statistics	{'discipline': 1, 'important': 1, 'often': 1, 'bayesian': 1, 'techniques': 1, 'computer': 1}
discipline	{'statistics': 1, 'that': 1}
concerns	{'that': 1, 'collection': 1}
collection	{'concerns': 1, 'organization': 1}
organization	{'collection': 1, 'analysis': 1}
analysis	{'organization': 1, 'interpretation': 1, 'statistical': 1, 'often': 1}
interpretation	{'analysis': 1, 'presentation': 1}
presentation	{'interpretation': 1, 'data': 1}
data	{'presentation': 1, 'statistical': 1, 'essential': 1, 'science': 2, 'unstructured': 1, 'it': 1}
statistical	{'data': 1, 'analysis': 1}
often	{'analysis': 1, 'uses': 1, 'statistics': 1, 'used': 1}
uses	{'often': 1, 'probability': 1, 'that': 1, 'scientific': 1}
theory	{'probability': 1, 'essential': 1}
essential	{'theory': 1, 'data': 1}
science	{'data': 2, 'interdisciplinary': 1, 'computer': 1, 'information': 2}
normal	{'distribution': 3}
distribution	{'normal': 3, 'continuous': 1, 'probability': 1, 'it': 1, 'gaussian': 1, 'important': 1}
continuous	{'distribution': 1, 'probability': 1}
also	{'it': 1, 'called': 1}
called	{'also': 1, 'gaussian': 1}
gaussian	{'called': 1, 'distribution': 1}
important	{'distribution': 1, 'statistics': 1}
used	{'often': 1, 'natural': 1}
natural	{'used': 1, 'social': 1}
social	{'natural': 1, 'sciences': 1}
sciences	{'social': 1}
bayes	{'theorem': 1}
theorem	{'bayes': 1, 'describes': 1}
describes	{'theorem': 1, 'probability': 1}
based	{'event': 1, 'prior': 1}
prior	{'based': 1, 'knowledge': 1}
knowledge	{'prior': 1, 'conditions': 1, 'extract': 1, 'insights': 1}
conditions	{'knowledge': 1, 'that': 1}
might	{'that': 1, 'related': 1}
related	{'might': 1, 'event': 1}
fundamental	{'it': 1, 'bayesian': 1}
bayesian	{'fundamental': 1, 'statistics': 1}
interdisciplinary	{'science': 1, 'field': 1}
field	{'interdisciplinary': 1, 'that': 1}
scientific	{'uses': 1, 'methods': 1}
methods	{'scientific': 1, 'processes': 1}
processes	{'methods': 1, 'algorithms': 1}
algorithms	{'processes': 1, 'systems': 1}
systems	{'algorithms': 1, 'extract': 1}
extract	{'systems': 1, 'knowledge': 1}
insights	{'knowledge': 1, 'structured': 1}
structured	{'insights': 1, 'unstructured': 1}
unstructured	{'structured': 1, 'data': 1}
employs	{'it': 1, 'techniques': 1}
techniques	{'employs': 1, 'statistics': 1}
computer	{'statistics': 1, 'science': 1}
information	{'science': 2}
