investor	('investor', 'investors')
present	('presentation', 'present', 'presented', 'presentations', 'presents', 'presently')
q2	('q2',)
fy24	('fy24',)
august	('august',)
28	('28',)
2023	('2023',)
except	('except', 'exceptional', 'exception', 'exceptions')
histor	('historical', 'historically')
inform	('information', 'informs', 'informational', 'informed')
contain	('contained', 'contains', 'contain', 'containing', 'containment')
herein	('herein',)
certain	('certain',)
matter	('matters', 'matter')
includ	('including', 'include', 'includes', 'includible')
not	('not',)
limit	('limited', 'limitations', 'limit', 'limits', 'limitation', 'limiting')
statement	('statements', 'statement')
financi	('financial', 'financials')
posit	('position', 'positioned', 'positions', 'positive', 'positioning')
market	('markets', 'market', 'marketable', 'marketers', 'marketing', 'marketed')
opportun	('opportunity', 'opportunities')
demand	('demand', 'demands', 'demanding')
growth	('growth',)
driver	('drivers', 'driver')
csp	('csps', 'csp')
undertak	('undertaking', 'undertake')
gener	('generational', 'generative', 'generating', 'generation', 'generate', 'generates', 'general', 'generally', 'generations', 'generated')
transit	('transition', 'transitioned', 'transitioning', 'transitions')
updat	('update', 'updated', 'updates', 'updating')
infrastructur	('infrastructure',)
new	('new',)
era	('era', 'eras')
acceler	('accelerated', 'acceleration', 'accelerating', 'accelerate', 'accelerates', 'accelerator')
comput	('computing', 'compute', 'computers', 'computer', 'computation', 'computational', 'computationally', 'computed', 'computations')
ai	('ai', 'ais')
enterpris	('enterprises', 'enterprise')
race	('racing', 'race', 'races')
adopt	('adopt', 'adoption', 'adopted', 'adopts', 'adopting')
belief	('belief', 'beliefs')
global	('global', 'globally')
end	('end', 'ends', 'ended', 'ending')
game	('gaming', 'games', 'game', 'gamings')
ha	('has',)
return	('returned', 'returns', 'return', 'returning')
grow	('growing', 'grows', 'grow')
number	('number', 'numbers')
gpu	('gpu', 'gpus')
cloud	('cloud', 'clouds')
provid	('providers', 'providing', 'provider', 'providence')
deploy	('deploying', 'deploy', 'deployed', 'deployment')
volum	('volume', 'volumes')
hgx	('hgx',)
system	('systems', 'system')
base	('based', 'base', 'bases')
hopper	('hopper',)
amper	('ampere',)
architectur	('architecture', 'architectures', 'architectural')
expect	('expectation', 'expected', 'expectations', 'expect', 'expects')
data	('data',)
center	('center', 'centers')
suppli	('supply',)
increas	('increase', 'increased', 'increases', 'increasing')
each	('each',)
quarter	('quarter', 'quarters')
next	('next',)
year	('year', 'years')
larg	('large', 'largely')
upgrad	('upgrade', 'upgraded', 'upgrades')
ahead	('ahead',)
likelihood	('likelihood',)
season	('seasonality', 'season', 'seasoned', 'seasonal')
overal	('overall',)
shift	('shift', 'shifts', 'shifting')
rtx	('rtx',)
dlss	('dlss',)
ecosystem	('ecosystem', 'ecosystems')
continu	('continuing', 'continues', 'continued', 'continue', 'continuous', 'continuity', 'continuation', 'continuously', 'continually')
expand	('expand', 'expanding', 'expanded', 'expands')
time	('timing', 'time', 'times', 'timely')
desktop	('desktop', 'desktops')
workstat	('workstation', 'workstations')
refresh	('refresh', 'refreshment')
profession	('professional', 'professionals')
visual	('visualization', 'visual')
technolog	('technology', 'technologies', 'technological')
impact	('impact', 'impactful', 'impacts', 'impacted', 'impacting')
partnership	('partnership', 'partnerships')
mediatek	('mediatek', 'mediateks')
outlook	('outlook',)
sequenti	('sequential', 'sequentially')
driven	('driven',)
also	('also',)
contribut	('contributing', 'contributions', 'contribution', 'contribute', 'contributes', 'contributed')
tax	('tax', 'taxes', 'taxed', 'taxing')
rate	('rates', 'rate', 'rating', 'rated', 'ratings')
third	('third',)
fiscal	('fiscal',)
2024	('2024',)
benefit	('benefits', 'benefiting', 'benefit', 'benefited')
perform	('performance', 'perform', 'performing', 'performed')
featur	('features', 'featuring', 'feature', 'featured')
avail	('availability', 'available')
product	('products', 'production', 'product', 'productivity')
collabor	('collaborations', 'collaborating', 'collaborative', 'collaborate', 'collaboration')
nvidia	('nvidia', 'nvidias')
be	('being',)
broadli	('broadly',)
recogn	('recognized', 'recognizing', 'recognize', 'recognizes')
way	('way', 'ways')
advanc	('advance', 'advanced', 'advancing', 'advances', 'advancement')
moor	('moores', 'moore')
law	('law', 'laws', 'lawful', 'lawfully')
need	('needed', 'needs', 'need', 'needing')
tackl	('tackle',)
most	('most',)
valu	('value', 'valued', 'values', 'valuing')
everi	('every',)
stakehold	('stakeholder', 'stakeholders')
greatest	('greatest',)
forc	('force', 'forces')
unlock	('unlocking', 'unlock', 'unlocks')
industri	('industries', 'industrial', 'industry', 'industrys')
becom	('becoming', 'become', 'becomes')
factori	('factories', 'factory')
wave	('wave', 'waves')
robot	('robotics', 'robotic', 'robots', 'robot')
digit	('digitalization', 'digital', 'digitally', 'digitalize')
omnivers	('omniverse',)
essenti	('essential', 'essentially')
stack	('stacks', 'stack')
help	('helping', 'helps', 'help', 'helped')
bring	('bring', 'bringing', 'brings')
world	('worlds', 'world')
largest	('largest',)
expertis	('expertise',)
scale	('scale', 'scaling', 'scaled', 'scales')
revolution	('revolutionize', 'revolutionizing', 'revolutionized', 'revolutionizes')
busi	('businesses', 'business')
softwar	('software',)
servic	('services', 'service')
enabl	('enabling', 'enables', 'enable', 'enabler', 'enabled')
cost	('cost', 'costs')
time-to-solut	('time-to-solution',)
save	('savings', 'save', 'saved')
applic	('application', 'applications', 'applicable')
speed-up	('speed-ups', 'speed-up')
dividend	('dividend', 'dividends')
program	('program', 'programming', 'programs')
plan	('plan', 'planning', 'plans', 'planned')
automot	('automotive',)
design	('design', 'designed', 'designing', 'designers', 'designation', 'designated', 'designs', 'designate', 'designer')
win	('win', 'wins')
pipelin	('pipeline', 'pipelines')
ramp	('ramp', 'ramping', 'ramped')
aim	('aim', 'aimed')
engag	('engage', 'engagement', 'engaging', 'engaged', 'engages')
manufactur	('manufacturing', 'manufacture', 'manufacturers', 'manufacturer', 'manufactured')
supplier	('suppliers', 'supplier')
goal	('goal', 'goals')
effect	('effecting', 'effect', 'effective', 'effectively', 'effectiveness', 'effects', 'effected')
science-bas	('science-based',)
environment	('environmental', 'environmentally')
target	('targets', 'target', 'targeted', 'targeting')
2026	('2026',)
100%	('100%',)
renew	('renewable',)
electr	('electricity', 'electric', 'electrical')
oper	('operations', 'operating', 'operation', 'operational', 'operates', 'operate', 'operated', 'operative')
2025	('2025',)
annual	('annually', 'annual', 'annualized')
thereaft	('thereafter',)
forward-look	('forward-looking',)
other	('other', 'others')
go	('go', 'going')
beyond	('beyond',)
fact	('facts', 'fact')
made	('made',)
subject	('subject', 'subjects', 'subjective', 'subjectivity')
risk	('risks', 'risk')
uncertainti	('uncertainties', 'uncertainty')
may	('may',)
caus	('cause', 'causes', 'caused', 'causing')
actual	('actual', 'actually')
result	('results', 'resulting', 'result', 'resulted')
differ	('differ', 'different', 'difference', 'differing', 'differences', 'differs')
materi	('materially', 'material', 'materials', 'materialize', 'materializing')
import	('important', 'importance', 'import', 'imports')
factor	('factors', 'factor')
could	('could',)
econom	('economic', 'economics')
condit	('conditions', 'condition', 'conditioned')
relianc	('reliance',)
parti	('parties', 'party', 'partys')
assembl	('assemble', 'assembly', 'assembled')
packag	('package', 'packaging', 'packaged')
test	('test', 'testing', 'tested', 'tests')
develop	('development', 'develop', 'developers', 'developing', 'developed', 'developments', 'developer')
competit	('competition', 'competitive', 'competitiveness')
enhanc	('enhancements', 'enhances', 'enhanced', 'enhance', 'enhancement')
exist	('existing', 'exists', 'exist')
accept	('acceptance', 'accepted', 'accept', 'acceptability', 'acceptable')
partner	('partners', 'partnered', 'partner', 'partnering')
defect	('defects', 'defect')
chang	('changes', 'change', 'changed', 'chang', 'changs', 'changing')
consum	('consumer', 'consumers', 'consumed', 'consuming')
prefer	('preferences', 'preference', 'preferred', 'prefer')
standard	('standards', 'standardization', 'standardize', 'standard')
interfac	('interfaces',)
unexpect	('unexpected',)
loss	('loss', 'losses')
when	('when',)
integr	('integrated', 'integrate', 'integration', 'integrity', 'integral', 'integrating', 'integrations')
current	('current', 'currently')
project	('projections', 'projects', 'project', 'projected')
futur	('future',)
event	('events', 'event')
trend	('trends', 'trend')
believ	('believes', 'believe', 'believed')
affect	('affect', 'affected', 'affects', 'affecting')
strategi	('strategy', 'strategies')
short-term	('short-term',)
long-term	('long-term',)
object	('objectives', 'objective', 'objectively', 'objectivity', 'objects')
reli	('rely', 'relies')
upon	('upon',)
predict	('predictions', 'prediction', 'predictive', 'predict', 'predicting')
discuss	('discussed', 'discussion', 'discussions', 'discuss', 'discusses', 'discussing')
occur	('occur', 'occurs', 'occurred', 'occurring')
advers	('adversely', 'adverse')
those	('those',)
anticip	('anticipated', 'anticipate', 'anticipation', 'anticipates', 'anticipating')
impli	('implied',)
although	('although',)
reflect	('reflected', 'reflect', 'reflecting', 'reflects', 'reflections')
reason	('reasonable', 'reason', 'reasons', 'reasonably', 'reasonableness')
compani	('company', 'companys', 'companies')
cannot	('cannot',)
guarante	('guarantee', 'guarantees', 'guaranteed')
level	('levels', 'level')
activ	('activity', 'activities', 'active')
achiev	('achievements', 'achieves', 'achieve', 'achievement', 'achieving', 'achieved')
circumst	('circumstances',)
requir	('required', 'requires', 'requirements', 'require', 'requirement', 'requiring')
disclaim	('disclaims',)
oblig	('obligation', 'obligations', 'obligate')
complet	('complete', 'completed', 'completing', 'completion', 'completely', 'completeness')
pleas	('please',)
refer	('refer', 'reference', 'referred', 'refers', 'references')
report	('reports', 'report', 'reporting', 'reporter', 'reporters', 'reported', 'reportable')
file	('file', 'files', 'filed', 'filings', 'filing')
sec	('sec', 'secs')
recent	('recent', 'recently')
form	('form', 'formed', 'forms', 'forming')
10-k	('10-k',)
quarterli	('quarterly',)
10-q	('10-q',)
8-k	('8-k',)
copi	('copies', 'copy')
post	('posted', 'post')
websit	('website', 'websites')
without	('without',)
charg	('charge', 'charges', 'charged')
mani	('many',)
describ	('described', 'describe', 'describes')
remain	('remain', 'remains', 'remained', 'remaining')
stage	('stages',)
offer	('offered', 'offering', 'offerings', 'offer', 'offers')
when-and-if-avail	('when-and-if-available',)
basi	('basis',)
intend	('intended', 'intend', 'intends')
interpret	('interpreted', 'interpretation', 'interpret', 'interpretations')
commit	('commitment', 'committed', 'commitments')
promis	('promise', 'promising')
legal	('legal', 'legally')
releas	('release', 'releases', 'released')
function	('functionalities', 'functions', 'functional', 'function', 'functionally', 'functionality', 'functioning')
sole	('sole', 'solely')
discret	('discretion', 'discrete')
have	('have', 'having')
no	('no', 'nos')
liabil	('liability', 'liabilities')
failur	('failure', 'failures')
deliv	('deliver', 'delivers', 'delivering', 'delivered')
delay	('delay', 'delays', 'delayed')
deliveri	('delivery', 'deliveries')
set	('set', 'sets', 'setting', 'settings')
forth	('forth',)
use	('uses', 'useful')
non-gaap	('non-gaap',)
measur	('measures', 'measured', 'measuring', 'measure', 'measurement')
gross	('gross',)
profit	('profit', 'profitable', 'profits', 'profitability')
margin	('margin', 'margins', 'marginal')
expens	('expenses', 'expense', 'expensive', 'expensed')
incom	('income', 'incoming')
non-	('non-',)
gaap	('gaap',)
net	('net',)
dilut	('diluted', 'dilution', 'dilutive')
earn	('earnings', 'earn', 'earned')
per	('per',)
share	('share', 'shares', 'shared', 'sharing')
free	('free',)
cash	('cash',)
flow	('flow', 'flows')
understand	('understanding', 'understand', 'understands', 'understandings')
meant	('meant',)
isol	('isolation',)
substitut	('substitute', 'substituted', 'substitution', 'substitutes')
prepar	('prepared', 'preparing', 'preparation', 'prepares', 'prepare')
accord	('accordance', 'according')
further	('further',)
relev	('relevant',)
reconcili	('reconciliations', 'reconciliation')
compar	('comparable', 'compared', 'comparably', 'compare', 'compares', 'comparing')
found	('found', 'founded', 'founding')
slide	('slide',)
titl	('titled', 'title', 'titles')
content	('content', 'contents')
